"Codice Regione";"Regione";"Et√†";"Maschi";"Femmine";"Totale"
"13";"Abruzzo";0;4217;3866;8083
"13";"Abruzzo";1;4226;4103;8329
"13";"Abruzzo";2;4341;4079;8420
"13";"Abruzzo";3;4403;4246;8649
"13";"Abruzzo";4;4611;4414;9025
"13";"Abruzzo";5;5014;4668;9682
"13";"Abruzzo";6;5233;4924;10157
"13";"Abruzzo";7;5307;4989;10296
"13";"Abruzzo";8;5370;5062;10432
"13";"Abruzzo";9;5461;5136;10597
"13";"Abruzzo";10;5684;5463;11147
"13";"Abruzzo";11;5890;5397;11287
"13";"Abruzzo";12;5960;5624;11584
"13";"Abruzzo";13;5869;5539;11408
"13";"Abruzzo";14;6092;5763;11855
"13";"Abruzzo";15;5958;5676;11634
"13";"Abruzzo";16;5964;5588;11552
"13";"Abruzzo";17;5943;5751;11694
"13";"Abruzzo";18;6180;5610;11790
"13";"Abruzzo";19;6105;5592;11697
"13";"Abruzzo";20;6067;5492;11559
"13";"Abruzzo";21;6157;5778;11935
"13";"Abruzzo";22;6432;5713;12145
"13";"Abruzzo";23;6354;5784;12138
"13";"Abruzzo";24;6496;5976;12472
"13";"Abruzzo";25;6465;5854;12319
"13";"Abruzzo";26;6469;6096;12565
"13";"Abruzzo";27;6533;5926;12459
"13";"Abruzzo";28;6559;6235;12794
"13";"Abruzzo";29;6792;6299;13091
"13";"Abruzzo";30;7004;6536;13540
"13";"Abruzzo";31;6893;6555;13448
"13";"Abruzzo";32;7043;6710;13753
"13";"Abruzzo";33;7103;6661;13764
"13";"Abruzzo";34;7178;6861;14039
"13";"Abruzzo";35;6993;6869;13862
"13";"Abruzzo";36;7238;7081;14319
"13";"Abruzzo";37;7489;7296;14785
"13";"Abruzzo";38;7665;7396;15061
"13";"Abruzzo";39;7653;7406;15059
"13";"Abruzzo";40;7868;7896;15764
"13";"Abruzzo";41;7945;7800;15745
"13";"Abruzzo";42;8198;7937;16135
"13";"Abruzzo";43;8523;8331;16854
"13";"Abruzzo";44;8878;8627;17505
"13";"Abruzzo";45;8926;8718;17644
"13";"Abruzzo";46;9244;9163;18407
"13";"Abruzzo";47;9343;9621;18964
"13";"Abruzzo";48;9936;9847;19783
"13";"Abruzzo";49;9617;9890;19507
"13";"Abruzzo";50;9952;10121;20073
"13";"Abruzzo";51;9973;10462;20435
"13";"Abruzzo";52;9875;10180;20055
"13";"Abruzzo";53;10333;10557;20890
"13";"Abruzzo";54;10192;10397;20589
"13";"Abruzzo";55;10184;10651;20835
"13";"Abruzzo";56;10372;10722;21094
"13";"Abruzzo";57;10356;10729;21085
"13";"Abruzzo";58;10469;10659;21128
"13";"Abruzzo";59;9746;10176;19922
"13";"Abruzzo";60;9313;9809;19122
"13";"Abruzzo";61;8948;9810;18758
"13";"Abruzzo";62;8853;9599;18452
"13";"Abruzzo";63;8669;9405;18074
"13";"Abruzzo";64;8354;9001;17355
"13";"Abruzzo";65;8233;8856;17089
"13";"Abruzzo";66;8168;8575;16743
"13";"Abruzzo";67;7942;8709;16651
"13";"Abruzzo";68;7790;8537;16327
"13";"Abruzzo";69;7260;7981;15241
"13";"Abruzzo";70;7191;7928;15119
"13";"Abruzzo";71;6970;8036;15006
"13";"Abruzzo";72;7290;8061;15351
"13";"Abruzzo";73;7299;8208;15507
"13";"Abruzzo";74;7225;8309;15534
"13";"Abruzzo";75;6769;7751;14520
"13";"Abruzzo";76;6540;7379;13919
"13";"Abruzzo";77;4659;5629;10288
"13";"Abruzzo";78;4964;5852;10816
"13";"Abruzzo";79;4594;5710;10304
"13";"Abruzzo";80;4277;5421;9698
"13";"Abruzzo";81;4171;5312;9483
"13";"Abruzzo";82;4486;5969;10455
"13";"Abruzzo";83;4282;5903;10185
"13";"Abruzzo";84;3723;5158;8881
"13";"Abruzzo";85;3464;4852;8316
"13";"Abruzzo";86;2883;4353;7236
"13";"Abruzzo";87;2644;4176;6820
"13";"Abruzzo";88;2186;3748;5934
"13";"Abruzzo";89;1880;3485;5365
"13";"Abruzzo";90;1474;2761;4235
"13";"Abruzzo";91;1237;2565;3802
"13";"Abruzzo";92;1034;2290;3324
"13";"Abruzzo";93;731;1736;2467
"13";"Abruzzo";94;513;1331;1844
"13";"Abruzzo";95;386;1100;1486
"13";"Abruzzo";96;232;766;998
"13";"Abruzzo";97;178;610;788
"13";"Abruzzo";98;119;439;558
"13";"Abruzzo";99;64;281;345
"13";"Abruzzo";100;122;503;625
"13";"Abruzzo";999;621458;648402;1269860
"17";"Basilicata";0;1749;1492;3241
"17";"Basilicata";1;1737;1595;3332
"17";"Basilicata";2;1862;1656;3518
"17";"Basilicata";3;1921;1737;3658
"17";"Basilicata";4;1862;1818;3680
"17";"Basilicata";5;2077;1843;3920
"17";"Basilicata";6;2058;1943;4001
"17";"Basilicata";7;2089;1972;4061
"17";"Basilicata";8;2068;1997;4065
"17";"Basilicata";9;2092;1940;4032
"17";"Basilicata";10;2327;2092;4419
"17";"Basilicata";11;2273;2140;4413
"17";"Basilicata";12;2347;2206;4553
"17";"Basilicata";13;2477;2265;4742
"17";"Basilicata";14;2538;2341;4879
"17";"Basilicata";15;2514;2320;4834
"17";"Basilicata";16;2602;2371;4973
"17";"Basilicata";17;2573;2398;4971
"17";"Basilicata";18;2719;2648;5367
"17";"Basilicata";19;2857;2514;5371
"17";"Basilicata";20;2871;2643;5514
"17";"Basilicata";21;2943;2613;5556
"17";"Basilicata";22;3042;2663;5705
"17";"Basilicata";23;3016;2703;5719
"17";"Basilicata";24;3047;2586;5633
"17";"Basilicata";25;2994;2670;5664
"17";"Basilicata";26;3003;2679;5682
"17";"Basilicata";27;2968;2699;5667
"17";"Basilicata";28;2992;2777;5769
"17";"Basilicata";29;3094;2771;5865
"17";"Basilicata";30;3261;2959;6220
"17";"Basilicata";31;3071;2905;5976
"17";"Basilicata";32;3283;3017;6300
"17";"Basilicata";33;3202;2919;6121
"17";"Basilicata";34;3204;2953;6157
"17";"Basilicata";35;3187;2909;6096
"17";"Basilicata";36;3109;2859;5968
"17";"Basilicata";37;3252;2982;6234
"17";"Basilicata";38;3282;3079;6361
"17";"Basilicata";39;3213;3112;6325
"17";"Basilicata";40;3227;3230;6457
"17";"Basilicata";41;3278;3168;6446
"17";"Basilicata";42;3283;3180;6463
"17";"Basilicata";43;3422;3235;6657
"17";"Basilicata";44;3646;3429;7075
"17";"Basilicata";45;3573;3650;7223
"17";"Basilicata";46;3932;3828;7760
"17";"Basilicata";47;3838;3994;7832
"17";"Basilicata";48;4075;4011;8086
"17";"Basilicata";49;3982;3994;7976
"17";"Basilicata";50;3989;4164;8153
"17";"Basilicata";51;4043;4195;8238
"17";"Basilicata";52;4081;4273;8354
"17";"Basilicata";53;4290;4292;8582
"17";"Basilicata";54;4215;4353;8568
"17";"Basilicata";55;4349;4504;8853
"17";"Basilicata";56;4133;4499;8632
"17";"Basilicata";57;4328;4474;8802
"17";"Basilicata";58;4472;4649;9121
"17";"Basilicata";59;4222;4349;8571
"17";"Basilicata";60;4276;4342;8618
"17";"Basilicata";61;4042;4331;8373
"17";"Basilicata";62;3927;4262;8189
"17";"Basilicata";63;3801;4034;7835
"17";"Basilicata";64;3726;3870;7596
"17";"Basilicata";65;3452;3950;7402
"17";"Basilicata";66;3616;3892;7508
"17";"Basilicata";67;3559;3623;7182
"17";"Basilicata";68;3421;3729;7150
"17";"Basilicata";69;3200;3358;6558
"17";"Basilicata";70;3068;3395;6463
"17";"Basilicata";71;2968;3323;6291
"17";"Basilicata";72;3132;3341;6473
"17";"Basilicata";73;3147;3334;6481
"17";"Basilicata";74;3101;3518;6619
"17";"Basilicata";75;2732;3179;5911
"17";"Basilicata";76;2426;2837;5263
"17";"Basilicata";77;1805;2268;4073
"17";"Basilicata";78;1820;2140;3960
"17";"Basilicata";79;1751;2106;3857
"17";"Basilicata";80;1622;2125;3747
"17";"Basilicata";81;1575;2050;3625
"17";"Basilicata";82;1837;2353;4190
"17";"Basilicata";83;1744;2406;4150
"17";"Basilicata";84;1551;2251;3802
"17";"Basilicata";85;1396;2139;3535
"17";"Basilicata";86;1245;1928;3173
"17";"Basilicata";87;1076;1779;2855
"17";"Basilicata";88;1005;1655;2660
"17";"Basilicata";89;814;1481;2295
"17";"Basilicata";90;674;1160;1834
"17";"Basilicata";91;536;996;1532
"17";"Basilicata";92;422;939;1361
"17";"Basilicata";93;344;718;1062
"17";"Basilicata";94;225;509;734
"17";"Basilicata";95;183;411;594
"17";"Basilicata";96;110;327;437
"17";"Basilicata";97;77;224;301
"17";"Basilicata";98;45;142;187
"17";"Basilicata";99;46;111;157
"17";"Basilicata";100;51;164;215
"17";"Basilicata";999;264702;271957;536659
"18";"Calabria";0;6954;6507;13461
"18";"Calabria";1;6699;6409;13108
"18";"Calabria";2;7093;6828;13921
"18";"Calabria";3;7372;7056;14428
"18";"Calabria";4;7667;7289;14956
"18";"Calabria";5;7923;7583;15506
"18";"Calabria";6;8100;7666;15766
"18";"Calabria";7;8287;7820;16107
"18";"Calabria";8;8341;7823;16164
"18";"Calabria";9;8253;7947;16200
"18";"Calabria";10;8677;8022;16699
"18";"Calabria";11;8773;8172;16945
"18";"Calabria";12;8872;8507;17379
"18";"Calabria";13;9157;8494;17651
"18";"Calabria";14;9020;8835;17855
"18";"Calabria";15;9310;8655;17965
"18";"Calabria";16;9627;8920;18547
"18";"Calabria";17;9526;8825;18351
"18";"Calabria";18;9833;9119;18952
"18";"Calabria";19;9729;9031;18760
"18";"Calabria";20;9684;8905;18589
"18";"Calabria";21;9923;9325;19248
"18";"Calabria";22;10118;9412;19530
"18";"Calabria";23;10069;9258;19327
"18";"Calabria";24;10189;9426;19615
"18";"Calabria";25;9883;9242;19125
"18";"Calabria";26;10119;9339;19458
"18";"Calabria";27;10031;9673;19704
"18";"Calabria";28;10198;9627;19825
"18";"Calabria";29;10651;10043;20694
"18";"Calabria";30;10645;10418;21063
"18";"Calabria";31;10676;10371;21047
"18";"Calabria";32;10980;10478;21458
"18";"Calabria";33;11139;10732;21871
"18";"Calabria";34;11304;11003;22307
"18";"Calabria";35;11082;10964;22046
"18";"Calabria";36;11115;10955;22070
"18";"Calabria";37;11244;11041;22285
"18";"Calabria";38;11591;11027;22618
"18";"Calabria";39;11376;11211;22587
"18";"Calabria";40;11528;11579;23107
"18";"Calabria";41;11563;11529;23092
"18";"Calabria";42;11851;11763;23614
"18";"Calabria";43;12039;12145;24184
"18";"Calabria";44;12305;12255;24560
"18";"Calabria";45;12349;12879;25228
"18";"Calabria";46;13009;13336;26345
"18";"Calabria";47;13049;13362;26411
"18";"Calabria";48;13088;13661;26749
"18";"Calabria";49;13062;13590;26652
"18";"Calabria";50;13101;13847;26948
"18";"Calabria";51;13190;14112;27302
"18";"Calabria";52;13075;13974;27049
"18";"Calabria";53;13645;14884;28529
"18";"Calabria";54;13524;14556;28080
"18";"Calabria";55;13705;14667;28372
"18";"Calabria";56;13741;14846;28587
"18";"Calabria";57;13668;14647;28315
"18";"Calabria";58;14241;15334;29575
"18";"Calabria";59;13409;14416;27825
"18";"Calabria";60;13307;14389;27696
"18";"Calabria";61;13111;14259;27370
"18";"Calabria";62;13057;13971;27028
"18";"Calabria";63;12721;13581;26302
"18";"Calabria";64;11830;12647;24477
"18";"Calabria";65;12236;12816;25052
"18";"Calabria";66;11711;12506;24217
"18";"Calabria";67;11605;12330;23935
"18";"Calabria";68;11491;12152;23643
"18";"Calabria";69;10851;11444;22295
"18";"Calabria";70;10085;10887;20972
"18";"Calabria";71;10231;11124;21355
"18";"Calabria";72;10280;11229;21509
"18";"Calabria";73;10236;11056;21292
"18";"Calabria";74;9939;11271;21210
"18";"Calabria";75;9606;10743;20349
"18";"Calabria";76;8476;9841;18317
"18";"Calabria";77;6460;7496;13956
"18";"Calabria";78;6413;7332;13745
"18";"Calabria";79;5958;7261;13219
"18";"Calabria";80;5780;7069;12849
"18";"Calabria";81;5335;6740;12075
"18";"Calabria";82;5850;7482;13332
"18";"Calabria";83;5413;7129;12542
"18";"Calabria";84;4608;6627;11235
"18";"Calabria";85;4219;5945;10164
"18";"Calabria";86;3633;5687;9320
"18";"Calabria";87;3344;5268;8612
"18";"Calabria";88;2908;4650;7558
"18";"Calabria";89;2561;4250;6811
"18";"Calabria";90;1977;3699;5676
"18";"Calabria";91;1572;3082;4654
"18";"Calabria";92;1292;2717;4009
"18";"Calabria";93;947;2003;2950
"18";"Calabria";94;691;1569;2260
"18";"Calabria";95;508;1211;1719
"18";"Calabria";96;369;898;1267
"18";"Calabria";97;247;650;897
"18";"Calabria";98;153;492;645
"18";"Calabria";99;120;321;441
"18";"Calabria";100;153;480;633
"18";"Calabria";999;901656;939644;1841300
"15";"Campania";0;22791;21570;44361
"15";"Campania";1;22188;20978;43166
"15";"Campania";2;23073;21792;44865
"15";"Campania";3;23837;22768;46605
"15";"Campania";4;24701;23014;47715
"15";"Campania";5;25532;24376;49908
"15";"Campania";6;25727;24377;50104
"15";"Campania";7;26118;24763;50881
"15";"Campania";8;26677;24943;51620
"15";"Campania";9;26817;25748;52565
"15";"Campania";10;28483;26559;55042
"15";"Campania";11;29051;27251;56302
"15";"Campania";12;30024;27961;57985
"15";"Campania";13;30454;29007;59461
"15";"Campania";14;30763;29440;60203
"15";"Campania";15;31517;30071;61588
"15";"Campania";16;31937;29983;61920
"15";"Campania";17;32165;30413;62578
"15";"Campania";18;33424;31324;64748
"15";"Campania";19;33033;31351;64384
"15";"Campania";20;32525;30723;63248
"15";"Campania";21;33371;31100;64471
"15";"Campania";22;33567;31072;64639
"15";"Campania";23;33525;30947;64472
"15";"Campania";24;33411;30828;64239
"15";"Campania";25;33169;30850;64019
"15";"Campania";26;33005;31127;64132
"15";"Campania";27;32295;31537;63832
"15";"Campania";28;32749;31454;64203
"15";"Campania";29;32972;32250;65222
"15";"Campania";30;34157;33918;68075
"15";"Campania";31;33739;33755;67494
"15";"Campania";32;33798;33478;67276
"15";"Campania";33;33570;33608;67178
"15";"Campania";34;34207;34432;68639
"15";"Campania";35;33623;33148;66771
"15";"Campania";36;33277;33080;66357
"15";"Campania";37;34375;33778;68153
"15";"Campania";38;34538;35164;69702
"15";"Campania";39;35101;35326;70427
"15";"Campania";40;36275;36098;72373
"15";"Campania";41;35467;36121;71588
"15";"Campania";42;36235;36350;72585
"15";"Campania";43;36758;37591;74349
"15";"Campania";44;37756;38761;76517
"15";"Campania";45;38696;39486;78182
"15";"Campania";46;40042;41048;81090
"15";"Campania";47;41498;42259;83757
"15";"Campania";48;42579;44163;86742
"15";"Campania";49;41749;43694;85443
"15";"Campania";50;41851;43880;85731
"15";"Campania";51;41949;44484;86433
"15";"Campania";52;41230;43656;84886
"15";"Campania";53;42451;44491;86942
"15";"Campania";54;42157;44575;86732
"15";"Campania";55;42460;45290;87750
"15";"Campania";56;42793;45312;88105
"15";"Campania";57;42815;45194;88009
"15";"Campania";58;43582;46044;89626
"15";"Campania";59;40414;43434;83848
"15";"Campania";60;39155;42512;81667
"15";"Campania";61;38259;41405;79664
"15";"Campania";62;36418;39589;76007
"15";"Campania";63;35977;38777;74754
"15";"Campania";64;33746;36732;70478
"15";"Campania";65;33282;36058;69340
"15";"Campania";66;31391;34667;66058
"15";"Campania";67;31934;34571;66505
"15";"Campania";68;30977;34331;65308
"15";"Campania";69;28411;31361;59772
"15";"Campania";70;27154;30070;57224
"15";"Campania";71;27088;30007;57095
"15";"Campania";72;26978;30386;57364
"15";"Campania";73;26401;30266;56667
"15";"Campania";74;26504;30709;57213
"15";"Campania";75;24889;29318;54207
"15";"Campania";76;24557;29099;53656
"15";"Campania";77;19401;23415;42816
"15";"Campania";78;15999;19929;35928
"15";"Campania";79;16289;21446;37735
"15";"Campania";80;14950;19904;34854
"15";"Campania";81;13584;18962;32546
"15";"Campania";82;14117;20106;34223
"15";"Campania";83;12940;19083;32023
"15";"Campania";84;11074;16874;27948
"15";"Campania";85;9675;15109;24784
"15";"Campania";86;7981;13433;21414
"15";"Campania";87;7365;12552;19917
"15";"Campania";88;5906;10900;16806
"15";"Campania";89;5113;9848;14961
"15";"Campania";90;4183;8250;12433
"15";"Campania";91;3291;6978;10269
"15";"Campania";92;2704;6031;8735
"15";"Campania";93;1980;4490;6470
"15";"Campania";94;1367;3569;4936
"15";"Campania";95;915;2592;3507
"15";"Campania";96;620;1850;2470
"15";"Campania";97;388;1392;1780
"15";"Campania";98;262;896;1158
"15";"Campania";99;194;660;854
"15";"Campania";100;299;1092;1391
"15";"Campania";999;2731761;2860414;5592175
"08";"Emilia-Romagna";0;15274;14602;29876
"08";"Emilia-Romagna";1;15612;14561;30173
"08";"Emilia-Romagna";2;15706;14800;30506
"08";"Emilia-Romagna";3;16151;15592;31743
"08";"Emilia-Romagna";4;17380;16087;33467
"08";"Emilia-Romagna";5;17880;16572;34452
"08";"Emilia-Romagna";6;18427;17473;35900
"08";"Emilia-Romagna";7;19066;18016;37082
"08";"Emilia-Romagna";8;19454;18429;37883
"08";"Emilia-Romagna";9;19898;18926;38824
"08";"Emilia-Romagna";10;20667;19276;39943
"08";"Emilia-Romagna";11;20915;19821;40736
"08";"Emilia-Romagna";12;21758;20276;42034
"08";"Emilia-Romagna";13;21976;20731;42707
"08";"Emilia-Romagna";14;22018;20556;42574
"08";"Emilia-Romagna";15;22011;20439;42450
"08";"Emilia-Romagna";16;21751;20236;41987
"08";"Emilia-Romagna";17;21472;20009;41481
"08";"Emilia-Romagna";18;21482;19976;41458
"08";"Emilia-Romagna";19;21103;19298;40401
"08";"Emilia-Romagna";20;21429;19447;40876
"08";"Emilia-Romagna";21;21535;19790;41325
"08";"Emilia-Romagna";22;22353;20107;42460
"08";"Emilia-Romagna";23;21996;19916;41912
"08";"Emilia-Romagna";24;22720;19714;42434
"08";"Emilia-Romagna";25;22503;20333;42836
"08";"Emilia-Romagna";26;22276;20530;42806
"08";"Emilia-Romagna";27;22475;20454;42929
"08";"Emilia-Romagna";28;22797;21186;43983
"08";"Emilia-Romagna";29;23082;21475;44557
"08";"Emilia-Romagna";30;24234;22905;47139
"08";"Emilia-Romagna";31;24280;22898;47178
"08";"Emilia-Romagna";32;24719;23644;48363
"08";"Emilia-Romagna";33;24427;23649;48076
"08";"Emilia-Romagna";34;24762;23767;48529
"08";"Emilia-Romagna";35;24229;24006;48235
"08";"Emilia-Romagna";36;24329;24284;48613
"08";"Emilia-Romagna";37;25149;25016;50165
"08";"Emilia-Romagna";38;25743;25580;51323
"08";"Emilia-Romagna";39;26222;26160;52382
"08";"Emilia-Romagna";40;26930;26889;53819
"08";"Emilia-Romagna";41;27064;26937;54001
"08";"Emilia-Romagna";42;28125;27891;56016
"08";"Emilia-Romagna";43;28998;29203;58201
"08";"Emilia-Romagna";44;31027;30880;61907
"08";"Emilia-Romagna";45;32166;32352;64518
"08";"Emilia-Romagna";46;33765;33752;67517
"08";"Emilia-Romagna";47;35457;35542;70999
"08";"Emilia-Romagna";48;37062;36781;73843
"08";"Emilia-Romagna";49;36887;36918;73805
"08";"Emilia-Romagna";50;37089;37005;74094
"08";"Emilia-Romagna";51;37219;37201;74420
"08";"Emilia-Romagna";52;36420;36910;73330
"08";"Emilia-Romagna";53;36839;37187;74026
"08";"Emilia-Romagna";54;36531;36809;73340
"08";"Emilia-Romagna";55;36028;36335;72363
"08";"Emilia-Romagna";56;36185;36569;72754
"08";"Emilia-Romagna";57;35527;36090;71617
"08";"Emilia-Romagna";58;35897;36888;72785
"08";"Emilia-Romagna";59;33316;34520;67836
"08";"Emilia-Romagna";60;31830;33581;65411
"08";"Emilia-Romagna";61;30975;32863;63838
"08";"Emilia-Romagna";62;29815;31905;61720
"08";"Emilia-Romagna";63;28986;31015;60001
"08";"Emilia-Romagna";64;27474;29455;56929
"08";"Emilia-Romagna";65;26934;29246;56180
"08";"Emilia-Romagna";66;26394;28766;55160
"08";"Emilia-Romagna";67;25079;27566;52645
"08";"Emilia-Romagna";68;23903;26931;50834
"08";"Emilia-Romagna";69;22866;25664;48530
"08";"Emilia-Romagna";70;22134;25490;47624
"08";"Emilia-Romagna";71;21788;24909;46697
"08";"Emilia-Romagna";72;22530;26152;48682
"08";"Emilia-Romagna";73;22657;26167;48824
"08";"Emilia-Romagna";74;23676;27497;51173
"08";"Emilia-Romagna";75;23424;26731;50155
"08";"Emilia-Romagna";76;23018;27272;50290
"08";"Emilia-Romagna";77;15681;19284;34965
"08";"Emilia-Romagna";78;17339;21153;38492
"08";"Emilia-Romagna";79;16682;20670;37352
"08";"Emilia-Romagna";80;15707;20071;35778
"08";"Emilia-Romagna";81;15570;20116;35686
"08";"Emilia-Romagna";82;16006;21816;37822
"08";"Emilia-Romagna";83;15002;20839;35841
"08";"Emilia-Romagna";84;14070;19852;33922
"08";"Emilia-Romagna";85;11872;16990;28862
"08";"Emilia-Romagna";86;9704;14966;24670
"08";"Emilia-Romagna";87;9351;14812;24163
"08";"Emilia-Romagna";88;8040;13537;21577
"08";"Emilia-Romagna";89;6524;11497;18021
"08";"Emilia-Romagna";90;5200;9810;15010
"08";"Emilia-Romagna";91;4395;8659;13054
"08";"Emilia-Romagna";92;3571;7815;11386
"08";"Emilia-Romagna";93;2647;5984;8631
"08";"Emilia-Romagna";94;1923;4892;6815
"08";"Emilia-Romagna";95;1360;3907;5267
"08";"Emilia-Romagna";96;869;2906;3775
"08";"Emilia-Romagna";97;633;2238;2871
"08";"Emilia-Romagna";98;443;1574;2017
"08";"Emilia-Romagna";99;232;1062;1294
"08";"Emilia-Romagna";100;324;1652;1976
"08";"Emilia-Romagna";999;2166421;2260508;4426929
"06";"Friuli-Venezia-Giulia";0;3776;3582;7358
"06";"Friuli-Venezia-Giulia";1;3757;3586;7343
"06";"Friuli-Venezia-Giulia";2;3844;3771;7615
"06";"Friuli-Venezia-Giulia";3;3938;3756;7694
"06";"Friuli-Venezia-Giulia";4;4138;3915;8053
"06";"Friuli-Venezia-Giulia";5;4321;4136;8457
"06";"Friuli-Venezia-Giulia";6;4536;4300;8836
"06";"Friuli-Venezia-Giulia";7;4520;4404;8924
"06";"Friuli-Venezia-Giulia";8;4866;4528;9394
"06";"Friuli-Venezia-Giulia";9;4923;4645;9568
"06";"Friuli-Venezia-Giulia";10;5107;4875;9982
"06";"Friuli-Venezia-Giulia";11;5327;4851;10178
"06";"Friuli-Venezia-Giulia";12;5449;5138;10587
"06";"Friuli-Venezia-Giulia";13;5504;5234;10738
"06";"Friuli-Venezia-Giulia";14;5546;5128;10674
"06";"Friuli-Venezia-Giulia";15;5528;5332;10860
"06";"Friuli-Venezia-Giulia";16;5534;5325;10859
"06";"Friuli-Venezia-Giulia";17;5538;5159;10697
"06";"Friuli-Venezia-Giulia";18;5514;5336;10850
"06";"Friuli-Venezia-Giulia";19;5671;5117;10788
"06";"Friuli-Venezia-Giulia";20;5652;5135;10787
"06";"Friuli-Venezia-Giulia";21;5819;5178;10997
"06";"Friuli-Venezia-Giulia";22;5962;5436;11398
"06";"Friuli-Venezia-Giulia";23;5811;5237;11048
"06";"Friuli-Venezia-Giulia";24;5960;5256;11216
"06";"Friuli-Venezia-Giulia";25;5888;5210;11098
"06";"Friuli-Venezia-Giulia";26;6059;5360;11419
"06";"Friuli-Venezia-Giulia";27;5855;5213;11068
"06";"Friuli-Venezia-Giulia";28;5817;5191;11008
"06";"Friuli-Venezia-Giulia";29;5957;5236;11193
"06";"Friuli-Venezia-Giulia";30;6151;5629;11780
"06";"Friuli-Venezia-Giulia";31;6090;5765;11855
"06";"Friuli-Venezia-Giulia";32;6195;5799;11994
"06";"Friuli-Venezia-Giulia";33;6133;5847;11980
"06";"Friuli-Venezia-Giulia";34;6226;5990;12216
"06";"Friuli-Venezia-Giulia";35;5941;5797;11738
"06";"Friuli-Venezia-Giulia";36;6172;5921;12093
"06";"Friuli-Venezia-Giulia";37;6316;6238;12554
"06";"Friuli-Venezia-Giulia";38;6576;6267;12843
"06";"Friuli-Venezia-Giulia";39;6518;6237;12755
"06";"Friuli-Venezia-Giulia";40;6897;6667;13564
"06";"Friuli-Venezia-Giulia";41;6986;6640;13626
"06";"Friuli-Venezia-Giulia";42;7277;6901;14178
"06";"Friuli-Venezia-Giulia";43;7470;7061;14531
"06";"Friuli-Venezia-Giulia";44;8069;7718;15787
"06";"Friuli-Venezia-Giulia";45;8149;7904;16053
"06";"Friuli-Venezia-Giulia";46;8555;8501;17056
"06";"Friuli-Venezia-Giulia";47;9050;8917;17967
"06";"Friuli-Venezia-Giulia";48;9696;9670;19366
"06";"Friuli-Venezia-Giulia";49;9489;9682;19171
"06";"Friuli-Venezia-Giulia";50;9826;9862;19688
"06";"Friuli-Venezia-Giulia";51;9870;9886;19756
"06";"Friuli-Venezia-Giulia";52;9864;10169;20033
"06";"Friuli-Venezia-Giulia";53;10105;9996;20101
"06";"Friuli-Venezia-Giulia";54;10050;9980;20030
"06";"Friuli-Venezia-Giulia";55;9981;10190;20171
"06";"Friuli-Venezia-Giulia";56;10048;10233;20281
"06";"Friuli-Venezia-Giulia";57;10132;10184;20316
"06";"Friuli-Venezia-Giulia";58;10299;10422;20721
"06";"Friuli-Venezia-Giulia";59;9590;9993;19583
"06";"Friuli-Venezia-Giulia";60;9094;9376;18470
"06";"Friuli-Venezia-Giulia";61;8925;9075;18000
"06";"Friuli-Venezia-Giulia";62;8600;8725;17325
"06";"Friuli-Venezia-Giulia";63;8364;8702;17066
"06";"Friuli-Venezia-Giulia";64;7694;8292;15986
"06";"Friuli-Venezia-Giulia";65;7402;8153;15555
"06";"Friuli-Venezia-Giulia";66;7394;7912;15306
"06";"Friuli-Venezia-Giulia";67;7152;7692;14844
"06";"Friuli-Venezia-Giulia";68;6890;7682;14572
"06";"Friuli-Venezia-Giulia";69;6738;7604;14342
"06";"Friuli-Venezia-Giulia";70;6541;7664;14205
"06";"Friuli-Venezia-Giulia";71;6475;7450;13925
"06";"Friuli-Venezia-Giulia";72;6840;7914;14754
"06";"Friuli-Venezia-Giulia";73;6727;7730;14457
"06";"Friuli-Venezia-Giulia";74;7085;8135;15220
"06";"Friuli-Venezia-Giulia";75;6820;8180;15000
"06";"Friuli-Venezia-Giulia";76;7156;8458;15614
"06";"Friuli-Venezia-Giulia";77;4739;5727;10466
"06";"Friuli-Venezia-Giulia";78;5458;6787;12245
"06";"Friuli-Venezia-Giulia";79;5224;6562;11786
"06";"Friuli-Venezia-Giulia";80;5014;6640;11654
"06";"Friuli-Venezia-Giulia";81;4916;6525;11441
"06";"Friuli-Venezia-Giulia";82;5023;6675;11698
"06";"Friuli-Venezia-Giulia";83;4417;6296;10713
"06";"Friuli-Venezia-Giulia";84;3951;5778;9729
"06";"Friuli-Venezia-Giulia";85;3408;5055;8463
"06";"Friuli-Venezia-Giulia";86;2763;4540;7303
"06";"Friuli-Venezia-Giulia";87;2427;4192;6619
"06";"Friuli-Venezia-Giulia";88;1894;3693;5587
"06";"Friuli-Venezia-Giulia";89;1633;3248;4881
"06";"Friuli-Venezia-Giulia";90;1336;2895;4231
"06";"Friuli-Venezia-Giulia";91;1067;2512;3579
"06";"Friuli-Venezia-Giulia";92;895;2335;3230
"06";"Friuli-Venezia-Giulia";93;569;1809;2378
"06";"Friuli-Venezia-Giulia";94;495;1422;1917
"06";"Friuli-Venezia-Giulia";95;335;1161;1496
"06";"Friuli-Venezia-Giulia";96;226;914;1140
"06";"Friuli-Venezia-Giulia";97;169;670;839
"06";"Friuli-Venezia-Giulia";98;103;492;595
"06";"Friuli-Venezia-Giulia";99;74;360;434
"06";"Friuli-Venezia-Giulia";100;85;567;652
"06";"Friuli-Venezia-Giulia";999;581956;610235;1192191
"12";"Lazio";0;18715;17640;36355
"12";"Lazio";1;19352;18425;37777
"12";"Lazio";2;19836;19022;38858
"12";"Lazio";3;21072;19730;40802
"12";"Lazio";4;22357;21248;43605
"12";"Lazio";5;23503;22058;45561
"12";"Lazio";6;24533;23210;47743
"12";"Lazio";7;24807;24010;48817
"12";"Lazio";8;26146;24405;50551
"12";"Lazio";9;26379;24944;51323
"12";"Lazio";10;27720;26444;54164
"12";"Lazio";11;27954;26393;54347
"12";"Lazio";12;28694;27051;55745
"12";"Lazio";13;28868;26919;55787
"12";"Lazio";14;28734;27571;56305
"12";"Lazio";15;29169;27250;56419
"12";"Lazio";16;28933;27315;56248
"12";"Lazio";17;28133;26349;54482
"12";"Lazio";18;28329;26600;54929
"12";"Lazio";19;27472;25944;53416
"12";"Lazio";20;27278;25476;52754
"12";"Lazio";21;27598;25605;53203
"12";"Lazio";22;28375;25900;54275
"12";"Lazio";23;28037;25524;53561
"12";"Lazio";24;28721;25919;54640
"12";"Lazio";25;28651;25946;54597
"12";"Lazio";26;28855;26323;55178
"12";"Lazio";27;29352;26356;55708
"12";"Lazio";28;29241;26966;56207
"12";"Lazio";29;29345;27794;57139
"12";"Lazio";30;30823;29358;60181
"12";"Lazio";31;30460;29296;59756
"12";"Lazio";32;31585;30233;61818
"12";"Lazio";33;31457;30434;61891
"12";"Lazio";34;32589;31727;64316
"12";"Lazio";35;32011;31886;63897
"12";"Lazio";36;32259;31722;63981
"12";"Lazio";37;33738;33341;67079
"12";"Lazio";38;34804;34279;69083
"12";"Lazio";39;35704;35100;70804
"12";"Lazio";40;36875;36864;73739
"12";"Lazio";41;36833;37476;74309
"12";"Lazio";42;37693;38034;75727
"12";"Lazio";43;38722;39504;78226
"12";"Lazio";44;40617;41667;82284
"12";"Lazio";45;41466;42525;83991
"12";"Lazio";46;42853;44614;87467
"12";"Lazio";47;45015;46949;91964
"12";"Lazio";48;46565;49133;95698
"12";"Lazio";49;46575;48994;95569
"12";"Lazio";50;46903;49608;96511
"12";"Lazio";51;46765;49670;96435
"12";"Lazio";52;46708;49369;96077
"12";"Lazio";53;47043;50207;97250
"12";"Lazio";54;46416;49499;95915
"12";"Lazio";55;46314;49903;96217
"12";"Lazio";56;46962;49524;96486
"12";"Lazio";57;46742;49448;96190
"12";"Lazio";58;47094;50351;97445
"12";"Lazio";59;43787;47241;91028
"12";"Lazio";60;41788;45071;86859
"12";"Lazio";61;40310;43762;84072
"12";"Lazio";62;38331;42015;80346
"12";"Lazio";63;36760;40611;77371
"12";"Lazio";64;34852;38836;73688
"12";"Lazio";65;34083;38135;72218
"12";"Lazio";66;33228;36916;70144
"12";"Lazio";67;32388;36316;68704
"12";"Lazio";68;31334;35719;67053
"12";"Lazio";69;29328;33505;62833
"12";"Lazio";70;28353;32617;60970
"12";"Lazio";71;27533;32250;59783
"12";"Lazio";72;28132;32902;61034
"12";"Lazio";73;27731;32711;60442
"12";"Lazio";74;28494;34383;62877
"12";"Lazio";75;27957;33568;61525
"12";"Lazio";76;26239;32607;58846
"12";"Lazio";77;19861;25336;45197
"12";"Lazio";78;19600;25037;44637
"12";"Lazio";79;19557;26016;45573
"12";"Lazio";80;18377;24786;43163
"12";"Lazio";81;17859;24477;42336
"12";"Lazio";82;18727;26399;45126
"12";"Lazio";83;17155;24612;41767
"12";"Lazio";84;15334;22909;38243
"12";"Lazio";85;13162;20239;33401
"12";"Lazio";86;11134;17926;29060
"12";"Lazio";87;10250;16858;27108
"12";"Lazio";88;8470;15110;23580
"12";"Lazio";89;7011;12995;20006
"12";"Lazio";90;5649;11046;16695
"12";"Lazio";91;4760;9556;14316
"12";"Lazio";92;3841;8704;12545
"12";"Lazio";93;2731;6453;9184
"12";"Lazio";94;1884;5148;7032
"12";"Lazio";95;1373;3900;5273
"12";"Lazio";96;990;2982;3972
"12";"Lazio";97;591;2131;2722
"12";"Lazio";98;402;1544;1946
"12";"Lazio";99;312;1104;1416
"12";"Lazio";100;435;1784;2219
"12";"Lazio";999;2765843;2941269;5707112
"07";"Liguria";0;4462;4104;8566
"07";"Liguria";1;4452;4191;8643
"07";"Liguria";2;4629;4462;9091
"07";"Liguria";3;4667;4421;9088
"07";"Liguria";4;4803;4532;9335
"07";"Liguria";5;5228;4876;10104
"07";"Liguria";6;5352;4931;10283
"07";"Liguria";7;5460;5185;10645
"07";"Liguria";8;5825;5393;11218
"07";"Liguria";9;5875;5420;11295
"07";"Liguria";10;6125;5816;11941
"07";"Liguria";11;6104;5716;11820
"07";"Liguria";12;6264;6030;12294
"07";"Liguria";13;6464;6368;12832
"07";"Liguria";14;6682;6430;13112
"07";"Liguria";15;6796;6094;12890
"07";"Liguria";16;6656;6366;13022
"07";"Liguria";17;6754;6235;12989
"07";"Liguria";18;6808;6398;13206
"07";"Liguria";19;6772;6137;12909
"07";"Liguria";20;6900;6344;13244
"07";"Liguria";21;6902;6502;13404
"07";"Liguria";22;7134;6553;13687
"07";"Liguria";23;7176;6342;13518
"07";"Liguria";24;7423;6470;13893
"07";"Liguria";25;7233;6519;13752
"07";"Liguria";26;7570;6600;14170
"07";"Liguria";27;7278;6534;13812
"07";"Liguria";28;7161;6692;13853
"07";"Liguria";29;7348;6819;14167
"07";"Liguria";30;7737;6974;14711
"07";"Liguria";31;7437;7062;14499
"07";"Liguria";32;7475;7148;14623
"07";"Liguria";33;7391;7158;14549
"07";"Liguria";34;7645;7383;15028
"07";"Liguria";35;7588;7008;14596
"07";"Liguria";36;7387;7059;14446
"07";"Liguria";37;7709;7407;15116
"07";"Liguria";38;7619;7365;14984
"07";"Liguria";39;7857;7538;15395
"07";"Liguria";40;7849;7583;15432
"07";"Liguria";41;8048;7893;15941
"07";"Liguria";42;7981;7929;15910
"07";"Liguria";43;8129;8457;16586
"07";"Liguria";44;8736;9210;17946
"07";"Liguria";45;9312;9612;18924
"07";"Liguria";46;10013;10078;20091
"07";"Liguria";47;10625;10859;21484
"07";"Liguria";48;11142;11682;22824
"07";"Liguria";49;11506;11690;23196
"07";"Liguria";50;12111;12284;24395
"07";"Liguria";51;12218;12326;24544
"07";"Liguria";52;12144;12641;24785
"07";"Liguria";53;12414;12887;25301
"07";"Liguria";54;12626;12960;25586
"07";"Liguria";55;12262;13036;25298
"07";"Liguria";56;12866;13438;26304
"07";"Liguria";57;13056;13650;26706
"07";"Liguria";58;13294;13617;26911
"07";"Liguria";59;12185;12982;25167
"07";"Liguria";60;11720;12546;24266
"07";"Liguria";61;11333;12116;23449
"07";"Liguria";62;10920;11632;22552
"07";"Liguria";63;10663;11532;22195
"07";"Liguria";64;10182;11095;21277
"07";"Liguria";65;10151;10829;20980
"07";"Liguria";66;9714;10505;20219
"07";"Liguria";67;9281;10247;19528
"07";"Liguria";68;9262;10184;19446
"07";"Liguria";69;8770;9877;18647
"07";"Liguria";70;8515;9499;18014
"07";"Liguria";71;8324;9640;17964
"07";"Liguria";72;8873;10067;18940
"07";"Liguria";73;8635;10382;19017
"07";"Liguria";74;9075;10788;19863
"07";"Liguria";75;9103;11088;20191
"07";"Liguria";76;8891;11204;20095
"07";"Liguria";77;6347;7961;14308
"07";"Liguria";78;6986;8924;15910
"07";"Liguria";79;6546;8603;15149
"07";"Liguria";80;6343;8765;15108
"07";"Liguria";81;6403;8871;15274
"07";"Liguria";82;6620;9410;16030
"07";"Liguria";83;6142;9043;15185
"07";"Liguria";84;5624;8541;14165
"07";"Liguria";85;4833;7674;12507
"07";"Liguria";86;4001;6730;10731
"07";"Liguria";87;3602;6303;9905
"07";"Liguria";88;3018;5628;8646
"07";"Liguria";89;2630;4963;7593
"07";"Liguria";90;2120;4675;6795
"07";"Liguria";91;1731;3894;5625
"07";"Liguria";92;1424;3580;5004
"07";"Liguria";93;1046;2768;3814
"07";"Liguria";94;807;2156;2963
"07";"Liguria";95;545;1628;2173
"07";"Liguria";96;356;1280;1636
"07";"Liguria";97;271;910;1181
"07";"Liguria";98;144;664;808
"07";"Liguria";99;90;447;537
"07";"Liguria";100;100;773;873
"07";"Liguria";999;723806;778818;1502624
"03";"Lombardia";0;35153;32818;67971
"03";"Lombardia";1;35699;33959;69658
"03";"Lombardia";2;36111;34173;70284
"03";"Lombardia";3;38143;36459;74602
"03";"Lombardia";4;40181;37801;77982
"03";"Lombardia";5;41913;39283;81196
"03";"Lombardia";6;42855;40990;83845
"03";"Lombardia";7;44755;41950;86705
"03";"Lombardia";8;45485;43175;88660
"03";"Lombardia";9;46451;43521;89972
"03";"Lombardia";10;47958;45223;93181
"03";"Lombardia";11;49004;46007;95011
"03";"Lombardia";12;50645;47082;97727
"03";"Lombardia";13;51429;48392;99821
"03";"Lombardia";14;51627;48574;100201
"03";"Lombardia";15;51133;47869;99002
"03";"Lombardia";16;51630;47986;99616
"03";"Lombardia";17;50370;46993;97363
"03";"Lombardia";18;50223;47711;97934
"03";"Lombardia";19;49284;45722;95006
"03";"Lombardia";20;49479;45419;94898
"03";"Lombardia";21;50352;46355;96707
"03";"Lombardia";22;51801;47092;98893
"03";"Lombardia";23;51702;46738;98440
"03";"Lombardia";24;52735;46807;99542
"03";"Lombardia";25;52180;47300;99480
"03";"Lombardia";26;52033;47680;99713
"03";"Lombardia";27;51406;47858;99264
"03";"Lombardia";28;51858;48905;100763
"03";"Lombardia";29;52672;50224;102896
"03";"Lombardia";30;54797;51772;106569
"03";"Lombardia";31;54735;52603;107338
"03";"Lombardia";32;56024;54009;110033
"03";"Lombardia";33;55918;54589;110507
"03";"Lombardia";34;57902;55708;113610
"03";"Lombardia";35;56338;54811;111149
"03";"Lombardia";36;56640;55004;111644
"03";"Lombardia";37;58188;56809;114997
"03";"Lombardia";38;59692;57855;117547
"03";"Lombardia";39;60774;59410;120184
"03";"Lombardia";40;63183;61496;124679
"03";"Lombardia";41;63590;61833;125423
"03";"Lombardia";42;64453;63124;127577
"03";"Lombardia";43;66177;64589;130766
"03";"Lombardia";44;70032;67951;137983
"03";"Lombardia";45;72746;70904;143650
"03";"Lombardia";46;75431;73797;149228
"03";"Lombardia";47;80332;78666;158998
"03";"Lombardia";48;82961;80638;163599
"03";"Lombardia";49;82214;81076;163290
"03";"Lombardia";50;83250;81403;164653
"03";"Lombardia";51;83449;81096;164545
"03";"Lombardia";52;82379;80825;163204
"03";"Lombardia";53;83984;82855;166839
"03";"Lombardia";54;83553;82288;165841
"03";"Lombardia";55;82655;82389;165044
"03";"Lombardia";56;84365;83451;167816
"03";"Lombardia";57;83150;83027;166177
"03";"Lombardia";58;82394;82291;164685
"03";"Lombardia";59;76186;77565;153751
"03";"Lombardia";60;71542;73676;145218
"03";"Lombardia";61;69022;71419;140441
"03";"Lombardia";62;66095;68986;135081
"03";"Lombardia";63;63499;67288;130787
"03";"Lombardia";64;60300;63584;123884
"03";"Lombardia";65;58482;62430;120912
"03";"Lombardia";66;57201;61352;118553
"03";"Lombardia";67;54425;60230;114655
"03";"Lombardia";68;53180;58358;111538
"03";"Lombardia";69;51069;56189;107258
"03";"Lombardia";70;50098;56206;106304
"03";"Lombardia";71;49006;55734;104740
"03";"Lombardia";72;50538;57580;108118
"03";"Lombardia";73;50294;57853;108147
"03";"Lombardia";74;51218;59772;110990
"03";"Lombardia";75;48622;57570;106192
"03";"Lombardia";76;49054;58891;107945
"03";"Lombardia";77;35052;43044;78096
"03";"Lombardia";78;36319;45844;82163
"03";"Lombardia";79;34560;44845;79405
"03";"Lombardia";80;33977;44996;78973
"03";"Lombardia";81;33048;45198;78246
"03";"Lombardia";82;34506;47704;82210
"03";"Lombardia";83;31958;45291;77249
"03";"Lombardia";84;28873;42548;71421
"03";"Lombardia";85;23688;36711;60399
"03";"Lombardia";86;19321;31839;51160
"03";"Lombardia";87;17509;30875;48384
"03";"Lombardia";88;14479;27037;41516
"03";"Lombardia";89;11765;23772;35537
"03";"Lombardia";90;9744;21035;30779
"03";"Lombardia";91;7612;18057;25669
"03";"Lombardia";92;6110;15595;21705
"03";"Lombardia";93;4277;12382;16659
"03";"Lombardia";94;2995;9575;12570
"03";"Lombardia";95;2170;7425;9595
"03";"Lombardia";96;1439;5452;6891
"03";"Lombardia";97;916;3941;4857
"03";"Lombardia";98;539;2754;3293
"03";"Lombardia";99;343;1845;2188
"03";"Lombardia";100;443;2912;3355
"03";"Lombardia";999;4889047;5061695;9950742
"11";"Marche";0;4540;4300;8840
"11";"Marche";1;4717;4595;9312
"11";"Marche";2;5009;4597;9606
"11";"Marche";3;5176;4686;9862
"11";"Marche";4;5311;5009;10320
"11";"Marche";5;5576;5297;10873
"11";"Marche";6;5975;5548;11523
"11";"Marche";7;6070;5852;11922
"11";"Marche";8;6323;5963;12286
"11";"Marche";9;6586;6038;12624
"11";"Marche";10;6602;6245;12847
"11";"Marche";11;6871;6669;13540
"11";"Marche";12;7076;6623;13699
"11";"Marche";13;7256;6820;14076
"11";"Marche";14;7289;6852;14141
"11";"Marche";15;7269;6752;14021
"11";"Marche";16;7126;6700;13826
"11";"Marche";17;7116;6737;13853
"11";"Marche";18;7254;6655;13909
"11";"Marche";19;7108;6681;13789
"11";"Marche";20;7284;6636;13920
"11";"Marche";21;7240;6672;13912
"11";"Marche";22;7689;6800;14489
"11";"Marche";23;7625;6849;14474
"11";"Marche";24;7904;6909;14813
"11";"Marche";25;7686;6917;14603
"11";"Marche";26;7630;6840;14470
"11";"Marche";27;7667;6876;14543
"11";"Marche";28;7468;6879;14347
"11";"Marche";29;7487;6998;14485
"11";"Marche";30;7854;7288;15142
"11";"Marche";31;7911;7154;15065
"11";"Marche";32;7957;7499;15456
"11";"Marche";33;7741;7451;15192
"11";"Marche";34;7922;7776;15698
"11";"Marche";35;7773;7539;15312
"11";"Marche";36;7995;7823;15818
"11";"Marche";37;8085;8186;16271
"11";"Marche";38;8356;8190;16546
"11";"Marche";39;8544;8501;17045
"11";"Marche";40;8936;8779;17715
"11";"Marche";41;8957;8862;17819
"11";"Marche";42;9411;9277;18688
"11";"Marche";43;9627;9789;19416
"11";"Marche";44;10278;10309;20587
"11";"Marche";45;10399;10738;21137
"11";"Marche";46;10957;10860;21817
"11";"Marche";47;11307;11576;22883
"11";"Marche";48;11751;11659;23410
"11";"Marche";49;11455;11685;23140
"11";"Marche";50;11614;11747;23361
"11";"Marche";51;11866;12152;24018
"11";"Marche";52;11565;11714;23279
"11";"Marche";53;11758;12369;24127
"11";"Marche";54;11729;12057;23786
"11";"Marche";55;11658;12163;23821
"11";"Marche";56;11771;12179;23950
"11";"Marche";57;11764;11990;23754
"11";"Marche";58;12123;12412;24535
"11";"Marche";59;11291;11810;23101
"11";"Marche";60;10928;11057;21985
"11";"Marche";61;10916;11269;22185
"11";"Marche";62;10380;10979;21359
"11";"Marche";63;9969;10736;20705
"11";"Marche";64;9691;10315;20006
"11";"Marche";65;9336;10189;19525
"11";"Marche";66;9303;10268;19571
"11";"Marche";67;8906;9913;18819
"11";"Marche";68;8665;9399;18064
"11";"Marche";69;8354;9193;17547
"11";"Marche";70;8388;8985;17373
"11";"Marche";71;8267;9159;17426
"11";"Marche";72;8371;9293;17664
"11";"Marche";73;8006;8962;16968
"11";"Marche";74;8095;9244;17339
"11";"Marche";75;7754;8840;16594
"11";"Marche";76;7462;8924;16386
"11";"Marche";77;6136;7217;13353
"11";"Marche";78;5728;6986;12714
"11";"Marche";79;5864;7240;13104
"11";"Marche";80;5372;6812;12184
"11";"Marche";81;5093;6843;11936
"11";"Marche";82;5565;7651;13216
"11";"Marche";83;5504;7519;13023
"11";"Marche";84;5046;7433;12479
"11";"Marche";85;4316;6244;10560
"11";"Marche";86;3551;5623;9174
"11";"Marche";87;3393;5476;8869
"11";"Marche";88;2842;4734;7576
"11";"Marche";89;2329;4298;6627
"11";"Marche";90;1807;3592;5399
"11";"Marche";91;1550;3230;4780
"11";"Marche";92;1231;2780;4011
"11";"Marche";93;902;2084;2986
"11";"Marche";94;670;1737;2407
"11";"Marche";95;508;1419;1927
"11";"Marche";96;300;1062;1362
"11";"Marche";97;228;775;1003
"11";"Marche";98;130;521;651
"11";"Marche";99;89;403;492
"11";"Marche";100;110;566;676
"11";"Marche";999;723340;757499;1480839
"14";"Molise";0;869;829;1698
"14";"Molise";1;845;824;1669
"14";"Molise";2;926;805;1731
"14";"Molise";3;985;923;1908
"14";"Molise";4;964;932;1896
"14";"Molise";5;1085;1013;2098
"14";"Molise";6;1051;1002;2053
"14";"Molise";7;1110;1009;2119
"14";"Molise";8;1160;1009;2169
"14";"Molise";9;1131;1074;2205
"14";"Molise";10;1194;1081;2275
"14";"Molise";11;1185;1155;2340
"14";"Molise";12;1290;1164;2454
"14";"Molise";13;1201;1091;2292
"14";"Molise";14;1323;1167;2490
"14";"Molise";15;1280;1225;2505
"14";"Molise";16;1286;1209;2495
"14";"Molise";17;1369;1239;2608
"14";"Molise";18;1402;1200;2602
"14";"Molise";19;1427;1263;2690
"14";"Molise";20;1426;1306;2732
"14";"Molise";21;1445;1308;2753
"14";"Molise";22;1475;1361;2836
"14";"Molise";23;1574;1380;2954
"14";"Molise";24;1636;1375;3011
"14";"Molise";25;1598;1370;2968
"14";"Molise";26;1517;1439;2956
"14";"Molise";27;1577;1447;3024
"14";"Molise";28;1631;1424;3055
"14";"Molise";29;1638;1514;3152
"14";"Molise";30;1704;1571;3275
"14";"Molise";31;1711;1442;3153
"14";"Molise";32;1667;1524;3191
"14";"Molise";33;1630;1508;3138
"14";"Molise";34;1689;1552;3241
"14";"Molise";35;1718;1500;3218
"14";"Molise";36;1701;1513;3214
"14";"Molise";37;1687;1609;3296
"14";"Molise";38;1711;1565;3276
"14";"Molise";39;1732;1581;3313
"14";"Molise";40;1776;1712;3488
"14";"Molise";41;1798;1740;3538
"14";"Molise";42;1766;1727;3493
"14";"Molise";43;1893;1821;3714
"14";"Molise";44;1904;1884;3788
"14";"Molise";45;1956;1944;3900
"14";"Molise";46;2080;1894;3974
"14";"Molise";47;2181;2107;4288
"14";"Molise";48;2242;2191;4433
"14";"Molise";49;2113;2189;4302
"14";"Molise";50;2164;2233;4397
"14";"Molise";51;2190;2185;4375
"14";"Molise";52;2169;2215;4384
"14";"Molise";53;2254;2352;4606
"14";"Molise";54;2280;2368;4648
"14";"Molise";55;2291;2432;4723
"14";"Molise";56;2352;2467;4819
"14";"Molise";57;2379;2415;4794
"14";"Molise";58;2467;2485;4952
"14";"Molise";59;2332;2292;4624
"14";"Molise";60;2212;2272;4484
"14";"Molise";61;2216;2194;4410
"14";"Molise";62;2216;2310;4526
"14";"Molise";63;2057;2225;4282
"14";"Molise";64;1922;2169;4091
"14";"Molise";65;2003;2074;4077
"14";"Molise";66;2026;2029;4055
"14";"Molise";67;1918;2046;3964
"14";"Molise";68;1928;2088;4016
"14";"Molise";69;1765;1880;3645
"14";"Molise";70;1809;1963;3772
"14";"Molise";71;1655;1801;3456
"14";"Molise";72;1751;1928;3679
"14";"Molise";73;1825;1981;3806
"14";"Molise";74;1741;1922;3663
"14";"Molise";75;1617;1826;3443
"14";"Molise";76;1541;1628;3169
"14";"Molise";77;1123;1307;2430
"14";"Molise";78;1074;1265;2339
"14";"Molise";79;969;1189;2158
"14";"Molise";80;926;1124;2050
"14";"Molise";81;933;1288;2221
"14";"Molise";82;1064;1422;2486
"14";"Molise";83;1027;1509;2536
"14";"Molise";84;861;1175;2036
"14";"Molise";85;784;1198;1982
"14";"Molise";86;697;1132;1829
"14";"Molise";87;645;1042;1687
"14";"Molise";88;570;1001;1571
"14";"Molise";89;462;878;1340
"14";"Molise";90;353;724;1077
"14";"Molise";91;310;639;949
"14";"Molise";92;292;596;888
"14";"Molise";93;198;447;645
"14";"Molise";94;137;322;459
"14";"Molise";95;101;299;400
"14";"Molise";96;75;214;289
"14";"Molise";97;49;147;196
"14";"Molise";98;28;125;153
"14";"Molise";99;29;85;114
"14";"Molise";100;34;140;174
"14";"Molise";999;143080;146760;289840
"01";"Piemonte";0;13333;12805;26138
"01";"Piemonte";1;13859;13112;26971
"01";"Piemonte";2;14287;13332;27619
"01";"Piemonte";3;14649;13954;28603
"01";"Piemonte";4;15082;14602;29684
"01";"Piemonte";5;16042;15382;31424
"01";"Piemonte";6;16788;15865;32653
"01";"Piemonte";7;17415;15948;33363
"01";"Piemonte";8;17654;17048;34702
"01";"Piemonte";9;18352;17219;35571
"01";"Piemonte";10;18981;17901;36882
"01";"Piemonte";11;19372;17840;37212
"01";"Piemonte";12;19614;18456;38070
"01";"Piemonte";13;20109;19033;39142
"01";"Piemonte";14;20412;19059;39471
"01";"Piemonte";15;20298;19120;39418
"01";"Piemonte";16;20059;18827;38886
"01";"Piemonte";17;20016;18787;38803
"01";"Piemonte";18;20193;18691;38884
"01";"Piemonte";19;20074;18656;38730
"01";"Piemonte";20;19725;18635;38360
"01";"Piemonte";21;20023;18714;38737
"01";"Piemonte";22;21210;19414;40624
"01";"Piemonte";23;21348;18839;40187
"01";"Piemonte";24;21804;19116;40920
"01";"Piemonte";25;21423;19527;40950
"01";"Piemonte";26;21504;19264;40768
"01";"Piemonte";27;21259;19301;40560
"01";"Piemonte";28;21323;19741;41064
"01";"Piemonte";29;21624;20023;41647
"01";"Piemonte";30;22307;20738;43045
"01";"Piemonte";31;22415;21033;43448
"01";"Piemonte";32;22945;21421;44366
"01";"Piemonte";33;22390;21229;43619
"01";"Piemonte";34;23020;21752;44772
"01";"Piemonte";35;22163;21528;43691
"01";"Piemonte";36;22636;21826;44462
"01";"Piemonte";37;22983;22555;45538
"01";"Piemonte";38;23052;22771;45823
"01";"Piemonte";39;23785;23453;47238
"01";"Piemonte";40;24606;24429;49035
"01";"Piemonte";41;24589;24588;49177
"01";"Piemonte";42;25234;25237;50471
"01";"Piemonte";43;26058;25745;51803
"01";"Piemonte";44;27574;27670;55244
"01";"Piemonte";45;28832;29297;58129
"01";"Piemonte";46;30173;30611;60784
"01";"Piemonte";47;31897;32452;64349
"01";"Piemonte";48;33460;33618;67078
"01";"Piemonte";49;33706;33473;67179
"01";"Piemonte";50;34352;34482;68834
"01";"Piemonte";51;34509;35273;69782
"01";"Piemonte";52;34175;34702;68877
"01";"Piemonte";53;35250;36044;71294
"01";"Piemonte";54;35040;35656;70696
"01";"Piemonte";55;34867;35727;70594
"01";"Piemonte";56;35220;35843;71063
"01";"Piemonte";57;34885;35738;70623
"01";"Piemonte";58;35107;36474;71581
"01";"Piemonte";59;32751;33973;66724
"01";"Piemonte";60;31138;32826;63964
"01";"Piemonte";61;30731;32482;63213
"01";"Piemonte";62;29511;31382;60893
"01";"Piemonte";63;28839;30186;59025
"01";"Piemonte";64;27944;29514;57458
"01";"Piemonte";65;27513;29320;56833
"01";"Piemonte";66;26620;28697;55317
"01";"Piemonte";67;25971;28079;54050
"01";"Piemonte";68;25283;27765;53048
"01";"Piemonte";69;24447;26741;51188
"01";"Piemonte";70;24200;26512;50712
"01";"Piemonte";71;23286;26390;49676
"01";"Piemonte";72;24074;27486;51560
"01";"Piemonte";73;24056;27466;51522
"01";"Piemonte";74;24897;28824;53721
"01";"Piemonte";75;24019;27903;51922
"01";"Piemonte";76;22855;27015;49870
"01";"Piemonte";77;17110;20476;37586
"01";"Piemonte";78;17651;21824;39475
"01";"Piemonte";79;16736;21749;38485
"01";"Piemonte";80;16482;21472;37954
"01";"Piemonte";81;15899;21523;37422
"01";"Piemonte";82;16599;22878;39477
"01";"Piemonte";83;15758;22115;37873
"01";"Piemonte";84;14428;20804;35232
"01";"Piemonte";85;12147;18139;30286
"01";"Piemonte";86;10171;15810;25981
"01";"Piemonte";87;9024;15163;24187
"01";"Piemonte";88;7535;13410;20945
"01";"Piemonte";89;6036;11680;17716
"01";"Piemonte";90;4928;10297;15225
"01";"Piemonte";91;4083;8937;13020
"01";"Piemonte";92;3354;7914;11268
"01";"Piemonte";93;2322;6169;8491
"01";"Piemonte";94;1588;4572;6160
"01";"Piemonte";95;1139;3570;4709
"01";"Piemonte";96;742;2547;3289
"01";"Piemonte";97;476;1806;2282
"01";"Piemonte";98;310;1337;1647
"01";"Piemonte";99;202;908;1110
"01";"Piemonte";100;225;1357;1582
"01";"Piemonte";999;2068142;2172594;4240736
"16";"Puglia";0;13668;12692;26360
"16";"Puglia";1;13628;12734;26362
"16";"Puglia";2;13708;12769;26477
"16";"Puglia";3;14232;13443;27675
"16";"Puglia";4;15033;13930;28963
"16";"Puglia";5;15466;14802;30268
"16";"Puglia";6;16082;15152;31234
"16";"Puglia";7;16150;15408;31558
"16";"Puglia";8;17104;15900;33004
"16";"Puglia";9;17275;16345;33620
"16";"Puglia";10;17994;16816;34810
"16";"Puglia";11;18515;17489;36004
"16";"Puglia";12;19078;18121;37199
"16";"Puglia";13;19352;18203;37555
"16";"Puglia";14;19687;18462;38149
"16";"Puglia";15;19933;18625;38558
"16";"Puglia";16;19827;18926;38753
"16";"Puglia";17;20471;19066;39537
"16";"Puglia";18;20921;20169;41090
"16";"Puglia";19;21044;19980;41024
"16";"Puglia";20;21006;20028;41034
"16";"Puglia";21;21791;20296;42087
"16";"Puglia";22;22130;20666;42796
"16";"Puglia";23;22411;20166;42577
"16";"Puglia";24;22245;20309;42554
"16";"Puglia";25;21862;20264;42126
"16";"Puglia";26;21682;20269;41951
"16";"Puglia";27;21299;19932;41231
"16";"Puglia";28;21319;20089;41408
"16";"Puglia";29;21668;20604;42272
"16";"Puglia";30;22486;21436;43922
"16";"Puglia";31;22035;21237;43272
"16";"Puglia";32;22130;21131;43261
"16";"Puglia";33;21444;21329;42773
"16";"Puglia";34;22403;21853;44256
"16";"Puglia";35;22032;21583;43615
"16";"Puglia";36;22061;21406;43467
"16";"Puglia";37;21750;21842;43592
"16";"Puglia";38;22492;22906;45398
"16";"Puglia";39;22812;22957;45769
"16";"Puglia";40;23457;24030;47487
"16";"Puglia";41;23699;24524;48223
"16";"Puglia";42;24697;25044;49741
"16";"Puglia";43;26030;26385;52415
"16";"Puglia";44;26961;27170;54131
"16";"Puglia";45;28076;28397;56473
"16";"Puglia";46;29004;29587;58591
"16";"Puglia";47;29869;30334;60203
"16";"Puglia";48;30294;31490;61784
"16";"Puglia";49;29363;30464;59827
"16";"Puglia";50;29104;29894;58998
"16";"Puglia";51;29655;30657;60312
"16";"Puglia";52;29371;30409;59780
"16";"Puglia";53;29698;31690;61388
"16";"Puglia";54;29770;31668;61438
"16";"Puglia";55;30387;31856;62243
"16";"Puglia";56;30466;32213;62679
"16";"Puglia";57;30224;32488;62712
"16";"Puglia";58;30729;32733;63462
"16";"Puglia";59;28303;30603;58906
"16";"Puglia";60;27552;29720;57272
"16";"Puglia";61;27072;29292;56364
"16";"Puglia";62;26517;28434;54951
"16";"Puglia";63;25535;27932;53467
"16";"Puglia";64;23762;26673;50435
"16";"Puglia";65;24243;26730;50973
"16";"Puglia";66;23425;26092;49517
"16";"Puglia";67;23168;25808;48976
"16";"Puglia";68;22418;24852;47270
"16";"Puglia";69;21490;24097;45587
"16";"Puglia";70;20458;23052;43510
"16";"Puglia";71;20937;23602;44539
"16";"Puglia";72;21338;24208;45546
"16";"Puglia";73;21017;23971;44988
"16";"Puglia";74;21796;25309;47105
"16";"Puglia";75;20125;23464;43589
"16";"Puglia";76;19183;23146;42329
"16";"Puglia";77;16062;19069;35131
"16";"Puglia";78;13864;17188;31052
"16";"Puglia";79;13451;16883;30334
"16";"Puglia";80;13261;17005;30266
"16";"Puglia";81;12248;15704;27952
"16";"Puglia";82;12594;16617;29211
"16";"Puglia";83;11669;16255;27924
"16";"Puglia";84;10269;14727;24996
"16";"Puglia";85;8933;13403;22336
"16";"Puglia";86;7546;11596;19142
"16";"Puglia";87;6903;11023;17926
"16";"Puglia";88;5865;9859;15724
"16";"Puglia";89;4877;8557;13434
"16";"Puglia";90;3853;7423;11276
"16";"Puglia";91;3193;6333;9526
"16";"Puglia";92;2674;5634;8308
"16";"Puglia";93;1838;4113;5951
"16";"Puglia";94;1346;3252;4598
"16";"Puglia";95;1004;2552;3556
"16";"Puglia";96;684;1853;2537
"16";"Puglia";97;442;1218;1660
"16";"Puglia";98;305;859;1164
"16";"Puglia";99;197;656;853
"16";"Puglia";100;259;964;1223
"16";"Puglia";999;1900756;2000096;3900852
"20";"Sardegna";0;4039;3702;7741
"20";"Sardegna";1;4198;4050;8248
"20";"Sardegna";2;4356;3965;8321
"20";"Sardegna";3;4514;4419;8933
"20";"Sardegna";4;4886;4575;9461
"20";"Sardegna";5;5270;4921;10191
"20";"Sardegna";6;5474;5114;10588
"20";"Sardegna";7;5843;5348;11191
"20";"Sardegna";8;5940;5533;11473
"20";"Sardegna";9;6098;5717;11815
"20";"Sardegna";10;6399;5966;12365
"20";"Sardegna";11;6705;6318;13023
"20";"Sardegna";12;6962;6476;13438
"20";"Sardegna";13;7036;6436;13472
"20";"Sardegna";14;6966;6567;13533
"20";"Sardegna";15;6901;6555;13456
"20";"Sardegna";16;7034;6536;13570
"20";"Sardegna";17;7128;6530;13658
"20";"Sardegna";18;7017;6471;13488
"20";"Sardegna";19;7182;6683;13865
"20";"Sardegna";20;6943;6616;13559
"20";"Sardegna";21;7096;6745;13841
"20";"Sardegna";22;7429;6832;14261
"20";"Sardegna";23;7355;6658;14013
"20";"Sardegna";24;7172;6447;13619
"20";"Sardegna";25;7304;6563;13867
"20";"Sardegna";26;7427;6581;14008
"20";"Sardegna";27;7591;6756;14347
"20";"Sardegna";28;7581;6894;14475
"20";"Sardegna";29;7577;7211;14788
"20";"Sardegna";30;7873;7561;15434
"20";"Sardegna";31;8158;7643;15801
"20";"Sardegna";32;8335;7968;16303
"20";"Sardegna";33;8456;7904;16360
"20";"Sardegna";34;8466;8096;16562
"20";"Sardegna";35;8567;8231;16798
"20";"Sardegna";36;8580;8360;16940
"20";"Sardegna";37;9015;8667;17682
"20";"Sardegna";38;9297;8811;18108
"20";"Sardegna";39;9407;9232;18639
"20";"Sardegna";40;10000;9673;19673
"20";"Sardegna";41;9939;9859;19798
"20";"Sardegna";42;10555;10070;20625
"20";"Sardegna";43;10536;10443;20979
"20";"Sardegna";44;11619;11239;22858
"20";"Sardegna";45;11960;11423;23383
"20";"Sardegna";46;12251;11999;24250
"20";"Sardegna";47;12822;12707;25529
"20";"Sardegna";48;13652;13070;26722
"20";"Sardegna";49;13593;13158;26751
"20";"Sardegna";50;13312;13116;26428
"20";"Sardegna";51;12990;13386;26376
"20";"Sardegna";52;13111;12949;26060
"20";"Sardegna";53;13393;13475;26868
"20";"Sardegna";54;12871;13337;26208
"20";"Sardegna";55;13388;13530;26918
"20";"Sardegna";56;13407;13795;27202
"20";"Sardegna";57;13398;13696;27094
"20";"Sardegna";58;13613;14008;27621
"20";"Sardegna";59;12789;13547;26336
"20";"Sardegna";60;12507;13148;25655
"20";"Sardegna";61;12125;12970;25095
"20";"Sardegna";62;11917;12340;24257
"20";"Sardegna";63;11536;12142;23678
"20";"Sardegna";64;11236;11976;23212
"20";"Sardegna";65;11128;12044;23172
"20";"Sardegna";66;10877;11771;22648
"20";"Sardegna";67;10566;11319;21885
"20";"Sardegna";68;10629;11420;22049
"20";"Sardegna";69;10095;10809;20904
"20";"Sardegna";70;9761;10710;20471
"20";"Sardegna";71;9426;10551;19977
"20";"Sardegna";72;9511;10420;19931
"20";"Sardegna";73;9102;10082;19184
"20";"Sardegna";74;9018;10296;19314
"20";"Sardegna";75;8515;9746;18261
"20";"Sardegna";76;7914;8929;16843
"20";"Sardegna";77;7086;8494;15580
"20";"Sardegna";78;6709;8245;14954
"20";"Sardegna";79;6076;8050;14126
"20";"Sardegna";80;6180;7948;14128
"20";"Sardegna";81;5336;7368;12704
"20";"Sardegna";82;5679;7920;13599
"20";"Sardegna";83;5151;7103;12254
"20";"Sardegna";84;4290;6393;10683
"20";"Sardegna";85;3648;5709;9357
"20";"Sardegna";86;3226;5255;8481
"20";"Sardegna";87;2668;4621;7289
"20";"Sardegna";88;2572;4405;6977
"20";"Sardegna";89;2184;3976;6160
"20";"Sardegna";90;1730;3376;5106
"20";"Sardegna";91;1461;2707;4168
"20";"Sardegna";92;1166;2488;3654
"20";"Sardegna";93;848;2008;2856
"20";"Sardegna";94;619;1577;2196
"20";"Sardegna";95;402;1203;1605
"20";"Sardegna";96;325;882;1207
"20";"Sardegna";97;195;635;830
"20";"Sardegna";98;138;467;605
"20";"Sardegna";99;90;292;382
"20";"Sardegna";100;160;517;677
"20";"Sardegna";999;772578;802450;1575028
"19";"Sicilia";0;19175;17642;36817
"19";"Sicilia";1;18999;18067;37066
"19";"Sicilia";2;19386;18267;37653
"19";"Sicilia";3;20013;18708;38721
"19";"Sicilia";4;20707;19626;40333
"19";"Sicilia";5;21370;20023;41393
"19";"Sicilia";6;21170;20233;41403
"19";"Sicilia";7;21982;20778;42760
"19";"Sicilia";8;22479;21326;43805
"19";"Sicilia";9;22182;21008;43190
"19";"Sicilia";10;23155;22170;45325
"19";"Sicilia";11;23362;22381;45743
"19";"Sicilia";12;24038;23013;47051
"19";"Sicilia";13;24719;23324;48043
"19";"Sicilia";14;25105;23799;48904
"19";"Sicilia";15;24899;23722;48621
"19";"Sicilia";16;25871;23800;49671
"19";"Sicilia";17;26193;24544;50737
"19";"Sicilia";18;26806;24948;51754
"19";"Sicilia";19;26301;24351;50652
"19";"Sicilia";20;26065;24472;50537
"19";"Sicilia";21;26846;24631;51477
"19";"Sicilia";22;27458;24600;52058
"19";"Sicilia";23;27302;25084;52386
"19";"Sicilia";24;26723;24783;51506
"19";"Sicilia";25;26728;24686;51414
"19";"Sicilia";26;26569;25091;51660
"19";"Sicilia";27;26408;25218;51626
"19";"Sicilia";28;26896;25577;52473
"19";"Sicilia";29;27207;26494;53701
"19";"Sicilia";30;28336;27477;55813
"19";"Sicilia";31;28046;27242;55288
"19";"Sicilia";32;28207;27743;55950
"19";"Sicilia";33;28155;27939;56094
"19";"Sicilia";34;28660;27930;56590
"19";"Sicilia";35;28000;27541;55541
"19";"Sicilia";36;28144;27613;55757
"19";"Sicilia";37;28276;28293;56569
"19";"Sicilia";38;28868;29011;57879
"19";"Sicilia";39;28639;28659;57298
"19";"Sicilia";40;29650;29729;59379
"19";"Sicilia";41;29674;29971;59645
"19";"Sicilia";42;30791;31076;61867
"19";"Sicilia";43;31068;31680;62748
"19";"Sicilia";44;32085;32557;64642
"19";"Sicilia";45;32349;33245;65594
"19";"Sicilia";46;34066;34796;68862
"19";"Sicilia";47;35045;35572;70617
"19";"Sicilia";48;35947;37112;73059
"19";"Sicilia";49;35206;36511;71717
"19";"Sicilia";50;35456;36694;72150
"19";"Sicilia";51;35776;37778;73554
"19";"Sicilia";52;35195;37643;72838
"19";"Sicilia";53;36604;38425;75029
"19";"Sicilia";54;36069;37985;74054
"19";"Sicilia";55;36367;38322;74689
"19";"Sicilia";56;35954;38189;74143
"19";"Sicilia";57;35468;37988;73456
"19";"Sicilia";58;36520;38701;75221
"19";"Sicilia";59;34356;36811;71167
"19";"Sicilia";60;33869;36777;70646
"19";"Sicilia";61;32940;35860;68800
"19";"Sicilia";62;32771;35968;68739
"19";"Sicilia";63;31217;34030;65247
"19";"Sicilia";64;29953;32909;62862
"19";"Sicilia";65;29633;32922;62555
"19";"Sicilia";66;28750;32092;60842
"19";"Sicilia";67;28719;31613;60332
"19";"Sicilia";68;27934;31642;59576
"19";"Sicilia";69;25824;28957;54781
"19";"Sicilia";70;25130;28665;53795
"19";"Sicilia";71;24816;27954;52770
"19";"Sicilia";72;25067;28846;53913
"19";"Sicilia";73;24795;28830;53625
"19";"Sicilia";74;25198;29520;54718
"19";"Sicilia";75;24267;28808;53075
"19";"Sicilia";76;21521;26157;47678
"19";"Sicilia";77;17923;21764;39687
"19";"Sicilia";78;16446;20726;37172
"19";"Sicilia";79;15093;19304;34397
"19";"Sicilia";80;14249;18885;33134
"19";"Sicilia";81;13727;18507;32234
"19";"Sicilia";82;14770;20627;35397
"19";"Sicilia";83;13509;18931;32440
"19";"Sicilia";84;11827;17312;29139
"19";"Sicilia";85;9786;14836;24622
"19";"Sicilia";86;8785;13497;22282
"19";"Sicilia";87;7783;12625;20408
"19";"Sicilia";88;6954;11609;18563
"19";"Sicilia";89;5861;10006;15867
"19";"Sicilia";90;4447;8325;12772
"19";"Sicilia";91;3634;7177;10811
"19";"Sicilia";92;3060;6468;9528
"19";"Sicilia";93;2001;4615;6616
"19";"Sicilia";94;1496;3747;5243
"19";"Sicilia";95;1058;2625;3683
"19";"Sicilia";96;700;2090;2790
"19";"Sicilia";97;490;1466;1956
"19";"Sicilia";98;291;1082;1373
"19";"Sicilia";99;186;694;880
"19";"Sicilia";100;303;1075;1378
"19";"Sicilia";999;2339874;2462142;4802016
"09";"Toscana";0;11231;10603;21834
"09";"Toscana";1;11679;11207;22886
"09";"Toscana";2;11773;10936;22709
"09";"Toscana";3;12184;11786;23970
"09";"Toscana";4;12946;12510;25456
"09";"Toscana";5;13800;12978;26778
"09";"Toscana";6;14113;13477;27590
"09";"Toscana";7;14624;13582;28206
"09";"Toscana";8;15287;14481;29768
"09";"Toscana";9;15448;14595;30043
"09";"Toscana";10;16290;15533;31823
"09";"Toscana";11;16527;15682;32209
"09";"Toscana";12;17118;16155;33273
"09";"Toscana";13;17229;16258;33487
"09";"Toscana";14;17965;16541;34506
"09";"Toscana";15;17777;16461;34238
"09";"Toscana";16;17598;16473;34071
"09";"Toscana";17;17621;16363;33984
"09";"Toscana";18;17692;16415;34107
"09";"Toscana";19;17194;15879;33073
"09";"Toscana";20;17431;16025;33456
"09";"Toscana";21;17408;16140;33548
"09";"Toscana";22;17803;16293;34096
"09";"Toscana";23;17571;15735;33306
"09";"Toscana";24;18196;16071;34267
"09";"Toscana";25;17903;16247;34150
"09";"Toscana";26;17797;16304;34101
"09";"Toscana";27;17584;16323;33907
"09";"Toscana";28;17586;16688;34274
"09";"Toscana";29;18046;16676;34722
"09";"Toscana";30;18577;17886;36463
"09";"Toscana";31;18576;17744;36320
"09";"Toscana";32;19560;18421;37981
"09";"Toscana";33;18977;18593;37570
"09";"Toscana";34;19688;19359;39047
"09";"Toscana";35;19240;19007;38247
"09";"Toscana";36;18886;19264;38150
"09";"Toscana";37;19913;20161;40074
"09";"Toscana";38;20307;20414;40721
"09";"Toscana";39;20772;21099;41871
"09";"Toscana";40;21499;21547;43046
"09";"Toscana";41;21700;21863;43563
"09";"Toscana";42;22377;22470;44847
"09";"Toscana";43;23237;23691;46928
"09";"Toscana";44;24723;25110;49833
"09";"Toscana";45;25561;26147;51708
"09";"Toscana";46;26584;27519;54103
"09";"Toscana";47;28090;28884;56974
"09";"Toscana";48;29322;30255;59577
"09";"Toscana";49;29374;30547;59921
"09";"Toscana";50;29922;30501;60423
"09";"Toscana";51;29871;30870;60741
"09";"Toscana";52;29658;29912;59570
"09";"Toscana";53;30280;30990;61270
"09";"Toscana";54;29404;30671;60075
"09";"Toscana";55;29447;30865;60312
"09";"Toscana";56;30079;31046;61125
"09";"Toscana";57;29905;30984;60889
"09";"Toscana";58;29992;31391;61383
"09";"Toscana";59;27904;29318;57222
"09";"Toscana";60;26782;28184;54966
"09";"Toscana";61;25855;27736;53591
"09";"Toscana";62;25197;26662;51859
"09";"Toscana";63;24528;25917;50445
"09";"Toscana";64;23057;25306;48363
"09";"Toscana";65;22519;24698;47217
"09";"Toscana";66;22002;24251;46253
"09";"Toscana";67;21305;23798;45103
"09";"Toscana";68;20887;23642;44529
"09";"Toscana";69;19951;22128;42079
"09";"Toscana";70;19534;21936;41470
"09";"Toscana";71;19485;21621;41106
"09";"Toscana";72;19885;22332;42217
"09";"Toscana";73;20316;23356;43672
"09";"Toscana";74;21341;24724;46065
"09";"Toscana";75;20914;24683;45597
"09";"Toscana";76;20632;24489;45121
"09";"Toscana";77;15585;18996;34581
"09";"Toscana";78;15179;18739;33918
"09";"Toscana";79;14697;18600;33297
"09";"Toscana";80;13560;17622;31182
"09";"Toscana";81;13431;18100;31531
"09";"Toscana";82;14322;19779;34101
"09";"Toscana";83;13295;18473;31768
"09";"Toscana";84;12648;17902;30550
"09";"Toscana";85;10413;15692;26105
"09";"Toscana";86;8801;13547;22348
"09";"Toscana";87;8197;13090;21287
"09";"Toscana";88;6739;11430;18169
"09";"Toscana";89;5622;10023;15645
"09";"Toscana";90;4520;8860;13380
"09";"Toscana";91;3764;7766;11530
"09";"Toscana";92;3042;6883;9925
"09";"Toscana";93;2210;5435;7645
"09";"Toscana";94;1684;4443;6127
"09";"Toscana";95;1217;3265;4482
"09";"Toscana";96;833;2517;3350
"09";"Toscana";97;474;1819;2293
"09";"Toscana";98;344;1308;1652
"09";"Toscana";99;246;928;1174
"09";"Toscana";100;253;1414;1667
"09";"Toscana";999;1772112;1879040;3651152
"04";"Trentino-Alto Adige/S√ºdtirol";0;4617;4359;8976
"04";"Trentino-Alto Adige/S√ºdtirol";1;4826;4535;9361
"04";"Trentino-Alto Adige/S√ºdtirol";2;4783;4542;9325
"04";"Trentino-Alto Adige/S√ºdtirol";3;5019;4624;9643
"04";"Trentino-Alto Adige/S√ºdtirol";4;5070;4776;9846
"04";"Trentino-Alto Adige/S√ºdtirol";5;5175;4901;10076
"04";"Trentino-Alto Adige/S√ºdtirol";6;5268;5108;10376
"04";"Trentino-Alto Adige/S√ºdtirol";7;5364;5092;10456
"04";"Trentino-Alto Adige/S√ºdtirol";8;5492;5173;10665
"04";"Trentino-Alto Adige/S√ºdtirol";9;5538;5136;10674
"04";"Trentino-Alto Adige/S√ºdtirol";10;5652;5349;11001
"04";"Trentino-Alto Adige/S√ºdtirol";11;5632;5387;11019
"04";"Trentino-Alto Adige/S√ºdtirol";12;5804;5405;11209
"04";"Trentino-Alto Adige/S√ºdtirol";13;5746;5382;11128
"04";"Trentino-Alto Adige/S√ºdtirol";14;5851;5526;11377
"04";"Trentino-Alto Adige/S√ºdtirol";15;5880;5416;11296
"04";"Trentino-Alto Adige/S√ºdtirol";16;5851;5464;11315
"04";"Trentino-Alto Adige/S√ºdtirol";17;6051;5459;11510
"04";"Trentino-Alto Adige/S√ºdtirol";18;6043;5646;11689
"04";"Trentino-Alto Adige/S√ºdtirol";19;5968;5486;11454
"04";"Trentino-Alto Adige/S√ºdtirol";20;5896;5443;11339
"04";"Trentino-Alto Adige/S√ºdtirol";21;6137;5562;11699
"04";"Trentino-Alto Adige/S√ºdtirol";22;6163;5790;11953
"04";"Trentino-Alto Adige/S√ºdtirol";23;6162;5768;11930
"04";"Trentino-Alto Adige/S√ºdtirol";24;6274;5874;12148
"04";"Trentino-Alto Adige/S√ºdtirol";25;6300;5773;12073
"04";"Trentino-Alto Adige/S√ºdtirol";26;6264;5798;12062
"04";"Trentino-Alto Adige/S√ºdtirol";27;6086;5590;11676
"04";"Trentino-Alto Adige/S√ºdtirol";28;6152;5695;11847
"04";"Trentino-Alto Adige/S√ºdtirol";29;6063;5726;11789
"04";"Trentino-Alto Adige/S√ºdtirol";30;6256;5871;12127
"04";"Trentino-Alto Adige/S√ºdtirol";31;6321;5908;12229
"04";"Trentino-Alto Adige/S√ºdtirol";32;6416;5898;12314
"04";"Trentino-Alto Adige/S√ºdtirol";33;6215;5930;12145
"04";"Trentino-Alto Adige/S√ºdtirol";34;6263;6016;12279
"04";"Trentino-Alto Adige/S√ºdtirol";35;6067;5950;12017
"04";"Trentino-Alto Adige/S√ºdtirol";36;6180;5892;12072
"04";"Trentino-Alto Adige/S√ºdtirol";37;6229;6056;12285
"04";"Trentino-Alto Adige/S√ºdtirol";38;6249;6044;12293
"04";"Trentino-Alto Adige/S√ºdtirol";39;6424;6303;12727
"04";"Trentino-Alto Adige/S√ºdtirol";40;6593;6533;13126
"04";"Trentino-Alto Adige/S√ºdtirol";41;6564;6444;13008
"04";"Trentino-Alto Adige/S√ºdtirol";42;6609;6570;13179
"04";"Trentino-Alto Adige/S√ºdtirol";43;6526;6690;13216
"04";"Trentino-Alto Adige/S√ºdtirol";44;6902;7018;13920
"04";"Trentino-Alto Adige/S√ºdtirol";45;7015;7015;14030
"04";"Trentino-Alto Adige/S√ºdtirol";46;7159;7383;14542
"04";"Trentino-Alto Adige/S√ºdtirol";47;7555;7735;15290
"04";"Trentino-Alto Adige/S√ºdtirol";48;8149;8116;16265
"04";"Trentino-Alto Adige/S√ºdtirol";49;7967;8238;16205
"04";"Trentino-Alto Adige/S√ºdtirol";50;8207;8275;16482
"04";"Trentino-Alto Adige/S√ºdtirol";51;8488;8533;17021
"04";"Trentino-Alto Adige/S√ºdtirol";52;8256;8395;16651
"04";"Trentino-Alto Adige/S√ºdtirol";53;8951;8654;17605
"04";"Trentino-Alto Adige/S√ºdtirol";54;8719;8629;17348
"04";"Trentino-Alto Adige/S√ºdtirol";55;8539;8705;17244
"04";"Trentino-Alto Adige/S√ºdtirol";56;8747;8778;17525
"04";"Trentino-Alto Adige/S√ºdtirol";57;8938;8724;17662
"04";"Trentino-Alto Adige/S√ºdtirol";58;8829;8757;17586
"04";"Trentino-Alto Adige/S√ºdtirol";59;8248;8193;16441
"04";"Trentino-Alto Adige/S√ºdtirol";60;7688;7869;15557
"04";"Trentino-Alto Adige/S√ºdtirol";61;7541;7838;15379
"04";"Trentino-Alto Adige/S√ºdtirol";62;7351;7384;14735
"04";"Trentino-Alto Adige/S√ºdtirol";63;7123;7128;14251
"04";"Trentino-Alto Adige/S√ºdtirol";64;6564;6778;13342
"04";"Trentino-Alto Adige/S√ºdtirol";65;6223;6728;12951
"04";"Trentino-Alto Adige/S√ºdtirol";66;6155;6344;12499
"04";"Trentino-Alto Adige/S√ºdtirol";67;5873;6095;11968
"04";"Trentino-Alto Adige/S√ºdtirol";68;5581;5856;11437
"04";"Trentino-Alto Adige/S√ºdtirol";69;5461;5775;11236
"04";"Trentino-Alto Adige/S√ºdtirol";70;5298;5658;10956
"04";"Trentino-Alto Adige/S√ºdtirol";71;5118;5425;10543
"04";"Trentino-Alto Adige/S√ºdtirol";72;5149;5652;10801
"04";"Trentino-Alto Adige/S√ºdtirol";73;4931;5382;10313
"04";"Trentino-Alto Adige/S√ºdtirol";74;4984;5461;10445
"04";"Trentino-Alto Adige/S√ºdtirol";75;4644;5383;10027
"04";"Trentino-Alto Adige/S√ºdtirol";76;4867;5785;10652
"04";"Trentino-Alto Adige/S√ºdtirol";77;3453;4023;7476
"04";"Trentino-Alto Adige/S√ºdtirol";78;3843;4683;8526
"04";"Trentino-Alto Adige/S√ºdtirol";79;3944;4870;8814
"04";"Trentino-Alto Adige/S√ºdtirol";80;3784;4750;8534
"04";"Trentino-Alto Adige/S√ºdtirol";81;3639;4714;8353
"04";"Trentino-Alto Adige/S√ºdtirol";82;3285;4460;7745
"04";"Trentino-Alto Adige/S√ºdtirol";83;3063;4194;7257
"04";"Trentino-Alto Adige/S√ºdtirol";84;2705;3832;6537
"04";"Trentino-Alto Adige/S√ºdtirol";85;2259;3308;5567
"04";"Trentino-Alto Adige/S√ºdtirol";86;1900;3085;4985
"04";"Trentino-Alto Adige/S√ºdtirol";87;1669;2852;4521
"04";"Trentino-Alto Adige/S√ºdtirol";88;1436;2627;4063
"04";"Trentino-Alto Adige/S√ºdtirol";89;1232;2326;3558
"04";"Trentino-Alto Adige/S√ºdtirol";90;1085;2028;3113
"04";"Trentino-Alto Adige/S√ºdtirol";91;859;1780;2639
"04";"Trentino-Alto Adige/S√ºdtirol";92;697;1616;2313
"04";"Trentino-Alto Adige/S√ºdtirol";93;461;1240;1701
"04";"Trentino-Alto Adige/S√ºdtirol";94;379;959;1338
"04";"Trentino-Alto Adige/S√ºdtirol";95;273;778;1051
"04";"Trentino-Alto Adige/S√ºdtirol";96;158;573;731
"04";"Trentino-Alto Adige/S√ºdtirol";97;109;451;560
"04";"Trentino-Alto Adige/S√ºdtirol";98;68;299;367
"04";"Trentino-Alto Adige/S√ºdtirol";99;60;263;323
"04";"Trentino-Alto Adige/S√ºdtirol";100;60;347;407
"04";"Trentino-Alto Adige/S√ºdtirol";999;531680;543637;1075317
"10";"Umbria";0;2536;2415;4951
"10";"Umbria";1;2677;2602;5279
"10";"Umbria";2;2758;2583;5341
"10";"Umbria";3;2868;2817;5685
"10";"Umbria";4;3048;2827;5875
"10";"Umbria";5;3169;2988;6157
"10";"Umbria";6;3338;3177;6515
"10";"Umbria";7;3371;3176;6547
"10";"Umbria";8;3544;3439;6983
"10";"Umbria";9;3719;3504;7223
"10";"Umbria";10;3795;3786;7581
"10";"Umbria";11;3881;3745;7626
"10";"Umbria";12;4040;3780;7820
"10";"Umbria";13;4020;3754;7774
"10";"Umbria";14;4199;4053;8252
"10";"Umbria";15;4253;3935;8188
"10";"Umbria";16;4196;3894;8090
"10";"Umbria";17;4166;3864;8030
"10";"Umbria";18;4031;3821;7852
"10";"Umbria";19;4111;3670;7781
"10";"Umbria";20;4016;3805;7821
"10";"Umbria";21;4082;3742;7824
"10";"Umbria";22;4098;3902;8000
"10";"Umbria";23;4264;3706;7970
"10";"Umbria";24;4286;3759;8045
"10";"Umbria";25;4178;3823;8001
"10";"Umbria";26;4210;3814;8024
"10";"Umbria";27;4145;3801;7946
"10";"Umbria";28;4078;3901;7979
"10";"Umbria";29;4211;3953;8164
"10";"Umbria";30;4439;4152;8591
"10";"Umbria";31;4305;4099;8404
"10";"Umbria";32;4345;4254;8599
"10";"Umbria";33;4438;4303;8741
"10";"Umbria";34;4586;4592;9178
"10";"Umbria";35;4472;4422;8894
"10";"Umbria";36;4462;4608;9070
"10";"Umbria";37;4655;4773;9428
"10";"Umbria";38;4690;4809;9499
"10";"Umbria";39;5047;5192;10239
"10";"Umbria";40;5097;5075;10172
"10";"Umbria";41;5118;5275;10393
"10";"Umbria";42;5273;5301;10574
"10";"Umbria";43;5418;5505;10923
"10";"Umbria";44;5616;5890;11506
"10";"Umbria";45;5927;6083;12010
"10";"Umbria";46;6120;6307;12427
"10";"Umbria";47;6295;6663;12958
"10";"Umbria";48;6624;6986;13610
"10";"Umbria";49;6636;6868;13504
"10";"Umbria";50;6488;6866;13354
"10";"Umbria";51;6574;7011;13585
"10";"Umbria";52;6628;6753;13381
"10";"Umbria";53;6665;7073;13738
"10";"Umbria";54;6613;7141;13754
"10";"Umbria";55;6501;7019;13520
"10";"Umbria";56;6599;6935;13534
"10";"Umbria";57;6868;7199;14067
"10";"Umbria";58;6875;7222;14097
"10";"Umbria";59;6245;6928;13173
"10";"Umbria";60;6157;6661;12818
"10";"Umbria";61;6162;6530;12692
"10";"Umbria";62;6025;6530;12555
"10";"Umbria";63;5770;6186;11956
"10";"Umbria";64;5442;5855;11297
"10";"Umbria";65;5283;5744;11027
"10";"Umbria";66;5350;5807;11157
"10";"Umbria";67;5171;5701;10872
"10";"Umbria";68;4982;5610;10592
"10";"Umbria";69;4921;5442;10363
"10";"Umbria";70;4566;5184;9750
"10";"Umbria";71;4830;5382;10212
"10";"Umbria";72;4867;5409;10276
"10";"Umbria";73;4988;5556;10544
"10";"Umbria";74;5265;5872;11137
"10";"Umbria";75;4763;5426;10189
"10";"Umbria";76;4438;5268;9706
"10";"Umbria";77;3520;4186;7706
"10";"Umbria";78;3583;4476;8059
"10";"Umbria";79;3733;4549;8282
"10";"Umbria";80;3298;4125;7423
"10";"Umbria";81;3286;4117;7403
"10";"Umbria";82;3536;4482;8018
"10";"Umbria";83;3134;4408;7542
"10";"Umbria";84;3083;4271;7354
"10";"Umbria";85;2390;3792;6182
"10";"Umbria";86;2071;3274;5345
"10";"Umbria";87;1972;3148;5120
"10";"Umbria";88;1705;2870;4575
"10";"Umbria";89;1443;2539;3982
"10";"Umbria";90;1090;2126;3216
"10";"Umbria";91;975;1959;2934
"10";"Umbria";92;751;1764;2515
"10";"Umbria";93;527;1315;1842
"10";"Umbria";94;383;1049;1432
"10";"Umbria";95;291;913;1204
"10";"Umbria";96;194;651;845
"10";"Umbria";97;140;511;651
"10";"Umbria";98;111;344;455
"10";"Umbria";99;42;234;276
"10";"Umbria";100;60;326;386
"10";"Umbria";999;413205;440932;854137
"02";"Valle d'Aosta/Vall√©e d'Aoste";0;403;379;782
"02";"Valle d'Aosta/Vall√©e d'Aoste";1;399;349;748
"02";"Valle d'Aosta/Vall√©e d'Aoste";2;388;394;782
"02";"Valle d'Aosta/Vall√©e d'Aoste";3;417;415;832
"02";"Valle d'Aosta/Vall√©e d'Aoste";4;476;411;887
"02";"Valle d'Aosta/Vall√©e d'Aoste";5;476;416;892
"02";"Valle d'Aosta/Vall√©e d'Aoste";6;511;457;968
"02";"Valle d'Aosta/Vall√©e d'Aoste";7;498;471;969
"02";"Valle d'Aosta/Vall√©e d'Aoste";8;558;503;1061
"02";"Valle d'Aosta/Vall√©e d'Aoste";9;513;519;1032
"02";"Valle d'Aosta/Vall√©e d'Aoste";10;590;559;1149
"02";"Valle d'Aosta/Vall√©e d'Aoste";11;626;583;1209
"02";"Valle d'Aosta/Vall√©e d'Aoste";12;589;574;1163
"02";"Valle d'Aosta/Vall√©e d'Aoste";13;641;582;1223
"02";"Valle d'Aosta/Vall√©e d'Aoste";14;618;602;1220
"02";"Valle d'Aosta/Vall√©e d'Aoste";15;639;578;1217
"02";"Valle d'Aosta/Vall√©e d'Aoste";16;663;586;1249
"02";"Valle d'Aosta/Vall√©e d'Aoste";17;585;561;1146
"02";"Valle d'Aosta/Vall√©e d'Aoste";18;602;594;1196
"02";"Valle d'Aosta/Vall√©e d'Aoste";19;615;601;1216
"02";"Valle d'Aosta/Vall√©e d'Aoste";20;609;530;1139
"02";"Valle d'Aosta/Vall√©e d'Aoste";21;638;561;1199
"02";"Valle d'Aosta/Vall√©e d'Aoste";22;641;609;1250
"02";"Valle d'Aosta/Vall√©e d'Aoste";23;623;584;1207
"02";"Valle d'Aosta/Vall√©e d'Aoste";24;630;577;1207
"02";"Valle d'Aosta/Vall√©e d'Aoste";25;606;572;1178
"02";"Valle d'Aosta/Vall√©e d'Aoste";26;627;592;1219
"02";"Valle d'Aosta/Vall√©e d'Aoste";27;628;543;1171
"02";"Valle d'Aosta/Vall√©e d'Aoste";28;563;561;1124
"02";"Valle d'Aosta/Vall√©e d'Aoste";29;599;561;1160
"02";"Valle d'Aosta/Vall√©e d'Aoste";30;664;615;1279
"02";"Valle d'Aosta/Vall√©e d'Aoste";31;613;552;1165
"02";"Valle d'Aosta/Vall√©e d'Aoste";32;603;655;1258
"02";"Valle d'Aosta/Vall√©e d'Aoste";33;662;587;1249
"02";"Valle d'Aosta/Vall√©e d'Aoste";34;663;640;1303
"02";"Valle d'Aosta/Vall√©e d'Aoste";35;614;641;1255
"02";"Valle d'Aosta/Vall√©e d'Aoste";36;624;643;1267
"02";"Valle d'Aosta/Vall√©e d'Aoste";37;652;637;1289
"02";"Valle d'Aosta/Vall√©e d'Aoste";38;663;652;1315
"02";"Valle d'Aosta/Vall√©e d'Aoste";39;713;682;1395
"02";"Valle d'Aosta/Vall√©e d'Aoste";40;682;725;1407
"02";"Valle d'Aosta/Vall√©e d'Aoste";41;652;678;1330
"02";"Valle d'Aosta/Vall√©e d'Aoste";42;750;682;1432
"02";"Valle d'Aosta/Vall√©e d'Aoste";43;711;704;1415
"02";"Valle d'Aosta/Vall√©e d'Aoste";44;878;843;1721
"02";"Valle d'Aosta/Vall√©e d'Aoste";45;836;832;1668
"02";"Valle d'Aosta/Vall√©e d'Aoste";46;855;931;1786
"02";"Valle d'Aosta/Vall√©e d'Aoste";47;902;948;1850
"02";"Valle d'Aosta/Vall√©e d'Aoste";48;976;978;1954
"02";"Valle d'Aosta/Vall√©e d'Aoste";49;996;1002;1998
"02";"Valle d'Aosta/Vall√©e d'Aoste";50;992;1029;2021
"02";"Valle d'Aosta/Vall√©e d'Aoste";51;999;1057;2056
"02";"Valle d'Aosta/Vall√©e d'Aoste";52;1013;1048;2061
"02";"Valle d'Aosta/Vall√©e d'Aoste";53;1068;1106;2174
"02";"Valle d'Aosta/Vall√©e d'Aoste";54;1028;1073;2101
"02";"Valle d'Aosta/Vall√©e d'Aoste";55;1056;1086;2142
"02";"Valle d'Aosta/Vall√©e d'Aoste";56;1087;1094;2181
"02";"Valle d'Aosta/Vall√©e d'Aoste";57;1034;1067;2101
"02";"Valle d'Aosta/Vall√©e d'Aoste";58;1135;1113;2248
"02";"Valle d'Aosta/Vall√©e d'Aoste";59;1050;1000;2050
"02";"Valle d'Aosta/Vall√©e d'Aoste";60;911;960;1871
"02";"Valle d'Aosta/Vall√©e d'Aoste";61;988;922;1910
"02";"Valle d'Aosta/Vall√©e d'Aoste";62;818;907;1725
"02";"Valle d'Aosta/Vall√©e d'Aoste";63;879;931;1810
"02";"Valle d'Aosta/Vall√©e d'Aoste";64;807;845;1652
"02";"Valle d'Aosta/Vall√©e d'Aoste";65;791;827;1618
"02";"Valle d'Aosta/Vall√©e d'Aoste";66;775;784;1559
"02";"Valle d'Aosta/Vall√©e d'Aoste";67;720;844;1564
"02";"Valle d'Aosta/Vall√©e d'Aoste";68;730;804;1534
"02";"Valle d'Aosta/Vall√©e d'Aoste";69;748;749;1497
"02";"Valle d'Aosta/Vall√©e d'Aoste";70;709;727;1436
"02";"Valle d'Aosta/Vall√©e d'Aoste";71;672;740;1412
"02";"Valle d'Aosta/Vall√©e d'Aoste";72;687;755;1442
"02";"Valle d'Aosta/Vall√©e d'Aoste";73;680;791;1471
"02";"Valle d'Aosta/Vall√©e d'Aoste";74;697;793;1490
"02";"Valle d'Aosta/Vall√©e d'Aoste";75;699;709;1408
"02";"Valle d'Aosta/Vall√©e d'Aoste";76;598;692;1290
"02";"Valle d'Aosta/Vall√©e d'Aoste";77;440;561;1001
"02";"Valle d'Aosta/Vall√©e d'Aoste";78;516;549;1065
"02";"Valle d'Aosta/Vall√©e d'Aoste";79;518;580;1098
"02";"Valle d'Aosta/Vall√©e d'Aoste";80;479;569;1048
"02";"Valle d'Aosta/Vall√©e d'Aoste";81;450;595;1045
"02";"Valle d'Aosta/Vall√©e d'Aoste";82;458;600;1058
"02";"Valle d'Aosta/Vall√©e d'Aoste";83;383;563;946
"02";"Valle d'Aosta/Vall√©e d'Aoste";84;353;547;900
"02";"Valle d'Aosta/Vall√©e d'Aoste";85;296;477;773
"02";"Valle d'Aosta/Vall√©e d'Aoste";86;242;402;644
"02";"Valle d'Aosta/Vall√©e d'Aoste";87;214;356;570
"02";"Valle d'Aosta/Vall√©e d'Aoste";88;170;328;498
"02";"Valle d'Aosta/Vall√©e d'Aoste";89;153;326;479
"02";"Valle d'Aosta/Vall√©e d'Aoste";90;126;260;386
"02";"Valle d'Aosta/Vall√©e d'Aoste";91;101;245;346
"02";"Valle d'Aosta/Vall√©e d'Aoste";92;94;224;318
"02";"Valle d'Aosta/Vall√©e d'Aoste";93;69;156;225
"02";"Valle d'Aosta/Vall√©e d'Aoste";94;46;135;181
"02";"Valle d'Aosta/Vall√©e d'Aoste";95;27;102;129
"02";"Valle d'Aosta/Vall√©e d'Aoste";96;22;78;100
"02";"Valle d'Aosta/Vall√©e d'Aoste";97;24;48;72
"02";"Valle d'Aosta/Vall√©e d'Aoste";98;10;30;40
"02";"Valle d'Aosta/Vall√©e d'Aoste";99;4;32;36
"02";"Valle d'Aosta/Vall√©e d'Aoste";100;8;34;42
"02";"Valle d'Aosta/Vall√©e d'Aoste";999;60254;62701;122955
"05";"Veneto";0;16466;15473;31939
"05";"Veneto";1;16908;16115;33023
"05";"Veneto";2;17177;15904;33081
"05";"Veneto";3;17593;16525;34118
"05";"Veneto";4;18640;17545;36185
"05";"Veneto";5;19439;18247;37686
"05";"Veneto";6;19980;18813;38793
"05";"Veneto";7;20352;19478;39830
"05";"Veneto";8;21014;20104;41118
"05";"Veneto";9;21667;20365;42032
"05";"Veneto";10;22698;21410;44108
"05";"Veneto";11;23057;21862;44919
"05";"Veneto";12;23850;22349;46199
"05";"Veneto";13;24232;22677;46909
"05";"Veneto";14;24611;23298;47909
"05";"Veneto";15;24326;23068;47394
"05";"Veneto";16;24454;23080;47534
"05";"Veneto";17;24429;22777;47206
"05";"Veneto";18;24887;23157;48044
"05";"Veneto";19;24229;22715;46944
"05";"Veneto";20;24304;22450;46754
"05";"Veneto";21;24530;22386;46916
"05";"Veneto";22;25402;23507;48909
"05";"Veneto";23;25117;23353;48470
"05";"Veneto";24;25727;23484;49211
"05";"Veneto";25;25603;23495;49098
"05";"Veneto";26;25487;23187;48674
"05";"Veneto";27;25186;22721;47907
"05";"Veneto";28;24893;23119;48012
"05";"Veneto";29;24627;23748;48375
"05";"Veneto";30;25931;24204;50135
"05";"Veneto";31;25559;24521;50080
"05";"Veneto";32;26344;24754;51098
"05";"Veneto";33;25743;25046;50789
"05";"Veneto";34;26236;25655;51891
"05";"Veneto";35;25515;24726;50241
"05";"Veneto";36;25333;25378;50711
"05";"Veneto";37;26600;26501;53101
"05";"Veneto";38;26633;26657;53290
"05";"Veneto";39;27492;26861;54353
"05";"Veneto";40;28085;28290;56375
"05";"Veneto";41;28825;28655;57480
"05";"Veneto";42;30015;29038;59053
"05";"Veneto";43;30907;30659;61566
"05";"Veneto";44;32933;32742;65675
"05";"Veneto";45;33946;34209;68155
"05";"Veneto";46;35844;35404;71248
"05";"Veneto";47;37572;37143;74715
"05";"Veneto";48;39899;39448;79347
"05";"Veneto";49;39662;39146;78808
"05";"Veneto";50;40366;39461;79827
"05";"Veneto";51;40627;40351;80978
"05";"Veneto";52;40654;40159;80813
"05";"Veneto";53;41670;41215;82885
"05";"Veneto";54;40852;40958;81810
"05";"Veneto";55;41319;41055;82374
"05";"Veneto";56;41488;41529;83017
"05";"Veneto";57;41502;41501;83003
"05";"Veneto";58;41362;42101;83463
"05";"Veneto";59;38773;39316;78089
"05";"Veneto";60;37209;37760;74969
"05";"Veneto";61;36035;37077;73112
"05";"Veneto";62;33935;34979;68914
"05";"Veneto";63;33506;34618;68124
"05";"Veneto";64;31108;32600;63708
"05";"Veneto";65;30252;31745;61997
"05";"Veneto";66;29313;31427;60740
"05";"Veneto";67;28094;30158;58252
"05";"Veneto";68;27597;29380;56977
"05";"Veneto";69;26501;28333;54834
"05";"Veneto";70;25689;27983;53672
"05";"Veneto";71;25203;27304;52507
"05";"Veneto";72;25598;28711;54309
"05";"Veneto";73;25179;28010;53189
"05";"Veneto";74;25326;28878;54204
"05";"Veneto";75;24264;28018;52282
"05";"Veneto";76;25812;30057;55869
"05";"Veneto";77;17004;20673;37677
"05";"Veneto";78;19333;23504;42837
"05";"Veneto";79;18915;23792;42707
"05";"Veneto";80;17630;22760;40390
"05";"Veneto";81;16950;22028;38978
"05";"Veneto";82;16901;22849;39750
"05";"Veneto";83;16042;21587;37629
"05";"Veneto";84;13893;20284;34177
"05";"Veneto";85;11649;17623;29272
"05";"Veneto";86;9542;15780;25322
"05";"Veneto";87;8848;14878;23726
"05";"Veneto";88;7462;13465;20927
"05";"Veneto";89;5778;11192;16970
"05";"Veneto";90;4716;10123;14839
"05";"Veneto";91;3779;8822;12601
"05";"Veneto";92;3104;7765;10869
"05";"Veneto";93;2176;5847;8023
"05";"Veneto";94;1587;4838;6425
"05";"Veneto";95;1151;3875;5026
"05";"Veneto";96;753;2784;3537
"05";"Veneto";97;492;2125;2617
"05";"Veneto";98;331;1354;1685
"05";"Veneto";99;213;1009;1222
"05";"Veneto";100;246;1475;1721
"05";"Veneto";999;2377688;2460565;4838253

